Whan Melibeus retourned was into his hous, and saugh al this meschief, he,	When Melibeus had returned into his house, and saw all this mischief, he,
For which resoun this noble wyf Prudence suffred hir housbonde	For which reason this noble wife Prudence allowed her husband
as wel as he abideth the deeth of his owene propre persone.'"	as well as he abides the death of his own self.'"
`Whan that thy frend is deed,' quod he, `lat nat thyne eyen to moyste been of teeris,	`When thy friend is dead,' said he, `let not thine eyes be too moist of tears,
and the smale wormes to the tree, right so anoyeth sorwe to the herte.	and the small worms to the tree, just so sorrow does harm to the heart.
"Lat calle," quod Prudence, "thy trewe freendes alle and thy lynage whiche that been wise. Telleth youre cas,	"Have summoned," said Prudence, "all thy true friends and of thy family those that are wise. Tell your case,
And by the manere of his speche it semed that in herte he baar a crueel ire,	And by the manner of his speech it seemed that in heart he bore a cruel anger,
But certes, as to the warisshynge of youre doghter, al be it so that she perilously be wounded,	But certainly, as to the curing of your daughter, although it be so that she is perilously wounded,
by leve and by conseil of othere that were wise, and seide:	by leave and by advice of others that were wise, and said:
that thou ne wante noon espie ne wacche thy persone for to save.	that thou not lack any spy nor guard in order to save thy person.
whan it is sufficeant and resonable.	when it is sufficient and reasonable.
right so men sholde wreken hir wronges whil that they been fresshe and newe;	just so men should avenge their wrongs while they are fresh and new;
that shal sterve yong by cause of thilke werre, or elles lyve in sorwe and dye in wrecchednesse.	that shall die young because of that same war, or else live in sorrow and die in wretchedness.
"I see wel," quod this wise man, "that the commune proverbe is sooth, that	"I see well," said this wise man, "that the common proverb is true, that
For Piers Alfonce seith, `Whoso that dooth to thee oother good or harm, haste thee nat to quiten it,	For Petrus Alphonsus says, `Whoever does to thee either good or harm, hasten thee not to requite it,
And also, certes, if I governed me by thy conseil,	And also, certainly, if I governed myself according to thy advice,
Whanne dame Prudence, ful debonairly and with greet pacience, hadde herd al that hir housbonde	When dame Prudence, very debonairly and with great patience, had heard all that her husband
yet thar ye nat accomplice thilke ordinaunce but yow like.	yet you need not carry out that plan unless you want to.
and enquere of lasse folk than hymself.'	and ask for advice from lesser folk than himself.'
many another man hath founden many a womman ful good and trewe.	many another man has found many a woman very good and true.
but oonly of hem that hadden lordshipe and maistrie of his persone, men wolden nat be conseilled so ofte.	but only of them that had lordship and mastery of his person, men would not be advised so often.
And sire, by youre leve, that am nat I,	And sir, by your leave, that am not I,
And ther as ye blamen alle wommen and hir resouns, I shal shewe yow by manye ensamples that	And whereas you blame all women and their reasons, I shall show you by many examples that
Abygail delivered Nabal hir housbonde fro David the kyng, that wolde have slayn hym,	Abigail delivered Nabal her husband from David the king, who would have slain him,
What is bettre than jaspre? Wisedoom.	What is better than jasper? Wisdom.
And, wyf, by cause of thy sweete wordes, and eek for I have assayed and preved thy grete sapience	And, wife, because of thy sweet words, and also because I have tested and proven thy great wisdom
and examyne wel youre thoghtes of swich thyng as yow thynketh that is best for youre profit.	and examine well your thoughts of such thing as it seems to you best for your advantage.
and with his viciouse wordes he stireth oother folk to angre and to ire.	and with his vicious words he stirs other folk to anger and to ire.
For, as ye herde her biforn, the commune proverbe is this, that `he that soone deemeth, soone repenteth.'	For, as you heard before this, the common proverb is this, that `he who soon judges, soon repents.'
Another clerk seith that `scarsly shaltou fynden any persone that may kepe conseil secrely.'	Another clerk says that `scarcely shalt thou find any person that can keep plans secretly.'
ne shewe hym nat thy wille and thyn entente.	nor show him not thy will and thine intent.
I seye that first ye shul clepe to youre conseil youre freendes that been trewe.	I say that first you shall call to your council your friends that are true.
swiche as han seyn and been expert in manye thynges and been approved in conseillynges.	such as have seen and are expert in many things and are proven in giving advice.
But looke alwey that thy conseillours have thilke thre condiciouns that I have seyd bifore --	But look always that thy advisors have those three conditions that I have said before --
and lightly troweth alle bountee in hymself.'	and easily believes all goodness in himself.'
And therfore seith Tullius, `Enclyne nat thyne eres to flatereres, ne taak no conseil of the wordes of flaterye.'	And therefore says Cicero, `Incline not thine ears to flatterers, and take no advice of the words of flattery.'
and lowteth to thee with his heed, ne trust hym nevere.	and bows to thee with his head, trust him never.
And Tullius seith, `Ther nys no myght so greet of any emperour that longe may endure,	And Cicero says, `There is no might so great of any emperor that long may endure,
And David seith, `Blisful is that man that hath nat folwed the conseilyng of shrewes.'	And David says, `Blissful is that man who has not followed the advice of scoundrels.'
for to do by thy conseillours, if resoun accorde therto,	for to act as thy advisors advise, if reason accord thereto,
and moore profitable, and han approved it by manye wise folk and olde,	and more beneficial, and have tested it by many wise and old folk,
chese rather to suffre than bigynne.	choose rather to suffer than begin.
"Now is it resoun and tyme that I shewe yow whanne and wherfore that	"Now is it reasonable and time that I show you when and wherefore that
and eek if so be that it be inpossible, or may nat goodly be parfourned or kept.	and also if it so be that it is impossible, or can not goodly be performed or kept.
ne distempre youre herte, thogh I speke thyng that yow displese.	nor upset your heart, though I speak something that may displease you.
But certes, ye han sodeynly cleped to youre conseil a greet multitude of peple,	But certainly, you have suddenly called to your council a great multitude of people,
Ye han erred also, for ye han shewed to youre conseillours	You have erred also, for you have shown to your advisors
Ye han erred also, for ye han maked no division bitwixe youre conseillours -- this is to seyn,	You have erred also, for you have made no division between your advisors -- this is to say,
but there as thou hast toold me heerbiforn	but whereas thou hast told me before now
I sey yow that the surgiens and phisiciens han seyd yow in youre conseil discreetly, as hem oughte,	I tell you that the surgeons and physicians have spoken to you in counselling you discretely, as they ought,
but ye oghte the rather gerdone hem and shewe hem youre largesse.	but you ought the rather to reward them and show them your generosity.
and to his owene plesaunce!	and to his own pleasure!
and so forth of othere thynges.	and so forth of other things .
And, sire, as to the firste point, that toucheth to the kepyng of youre persone,	And, sir, as to the first point, that touches on the keeping of your person,
and of hem shul ye axen help youre persone for to kepe. For Catoun seith,	and of them shall you ask help to guard your person. For Cato says,
and if he bereth a spere, hoold thee on the right syde,	and if he bears a spear, hold thyself on the right side,
to greet presumpcioun, hym shal yvel bityde.'	too great self-confidence, to him shall evil befall.'
And the book seith, `A litel thorn may prikke a kyng ful soore,	And the book says, `A little thorn may prick a king very sorely,
swiche as han castelles and othere manere edifices, and armure, and artelries,	such as have castles and other sorts of edifices, and armor, and artillery,
that he be biloved with hys subgetz and with his neighebores.	that he is beloved by his subjects and by his neighbors.
er thow bigynne, I rede that thou apparaille thee therto, and do it with greet deliberacion.	ere thou begin, I advise that thou prepare thyself for that, and do it with great deliberation.
which conseillours been ynogh repreved by the resouns aforeseyd.	which advisors are enough reproved by the reasons spoken earlier.
And lat us considere also who been they, and how manye been they,	And let us consider also who are they, and how many are they,
Ye knowen also that youre richesses mooten been dispended in diverse parties,	You know also that your riches must be dispended in several parts,
wheither it accorde to resoun.	whether it accord to reason.
but oonly swich thyng as we may doon rightfully.	but only such thing as we can do justly.
and of the vengeance-takynge upon that wolde engendre another vengeance,	and by the vengeance-taking thereupon that would engender another vengeance,
The cause formal is the manere of hir werkynge that broghten laddres and cloumben in at thy wyndowes.	The cause formal is the manner of their working who brought ladders and climbed in at thy windows.
ther may no man comprehende ne serchen hem suffisantly.'	there can no man comprehend nor study them sufficiently.'
for if thou ete of it out of mesure, thou shalt spewe' and be nedy and povre.	for if thou eat of it to excess, thou shalt vomit' and be needy and poor.
this is to seyn, the deedly synnes that been entred into thyn herte by thy fyve wittes.	this is to say, the deadly sins that are entered into thine heart by thy five senses.
and they that han wyl to do wikkednesse restreyne hir wikked purpos,	and they that have will to do wickedness restrain their wicked purpose,
but they beren it to punysse the shrewes and mysdoers and for to defende the goode men.'	but they bear it to punish the scoundrels and evildoers and to defend the good men.'
for `thynges that been folily doon, and that been in hope of Fortune, shullen nevere come to good ende.'	for `things that are foolishly done, and that are in hope of Fortune, shall never come to a good end.'
and bifore the juge ne liketh yow nat,	and before the judge pleases you not,
thou sompnest thyne adversaries to do thee a newe vileynye.'	thou summonest thine adversaries to do thee a new villainy.'
they sompne nat a man al oonly for to do newe wronges, but they comanden it.	they summon a man not entirely only to do new wrongs, but they command it.
And therfore seye I that it is good as now that ye suffre and be pacient.	And therefore say I that it is good for now that you suffer and be patient.
studie and bisye thee rather to stille the same grevaunce than for to venge thee.	take pains and busy thyself rather to still the same grievance than to avenge thyself.
First and foreward, if ye wole considere the defautes that been in youre owene persone,	First of all, if you will consider the faults that are in your own person,
`Jhesu Crist,' he seith, `hath suffred for us and yeven ensample to every man to folwe and sewe hym,	`Jesus Christ,' he says, `has suffered for us and given example to every man to follow and be guided by him,
`The joye of God,' he seith, `is perdurable' -- that is to seyn, everelastynge.	`The joy of God,' he says, `is perdurable' -- that is to say, everlasting.
And therfore seith Seint Jame in his Epistle that `pacience is a greet vertu of perfeccioun.'"	And therefore says Saint James in his Epistle that `patience is a great virtue of perfection.'"
and though I do a greet excesse; that is to seyn, that I venge oon outrage by another."	and though I do a great excess; that is to say, that I avenge one outrage by another."
certes ye seye sooth, whan the defense is doon anon withouten intervalle or withouten tariyng or delay,	certainly you say truth, when the defense is done immediately without interval or without tarrying or delay,
"Certes," quod Melibee, "I graunte yow that whan a man is inpacient and wrooth of that	"Certainly," said Melibee, "I grant you that when a man is impatient and angry with that
my grief and my disese -- toucheth me right ny.	my grief and my suffering -- touches me very closely.
"Certes, deere sire, I graunte yow that ye been riche and myghty	"Certainly, dear sir, I grant you that you are rich and mighty
And if thy fortune change that thou wexe povre, farewel freendshipe and felaweshipe,	And if thy fortune change that thou wax poor, farewell friendship and fellowship,
whan a free man by kynde or of burthe is constreyned by poverte	when a man free by nature or by birth is constrained by poverty
I graunte yow that richesses been goode to hem that geten hem wel	I grant you that riches are good to them that get them well
but that richesse that cometh litel and litel wexeth alwey and multiplieth.'	but those riches that come little by little always grow and multiply.'
yet shaltou nat been ydel ne slow to do thy profit, for thou shalt in alle wise flee ydelnesse.'	yet thou shalt not be idle nor slow to do thy benefit, for thou shalt in all ways flee idleness.'
And therfore seith Seint Jerome, `Dooth somme goode dedes that the devel,	And therefore says Saint Jerome, `Do some good deeds that the devil,
in swich a manere that men have no matiere ne cause to calle thee neither wrecche ne chynche,	in such a manner that men have no reason nor cause to call thee neither wretch nor miser,
`Wherto and why burieth a man his goodes by his grete avarice,	`For what reason and why buries a man his goods by his great avarice,
as wel sholde ye kepe yow and governe yow in swich a wise who men calle yow nat fool-large.	as well should you keep yourself and govern yourself in such a way that men do not call you foolishly generous.
For after the word of Salomon, `It is bettre to have a litel good with the love of God	For after the word of Solomon, `It is better to have a little good with the love of God
Afterward, in getynge of youre richesses and in usynge of hem,	Afterward, in getting of your riches and in using of them,
whan a man loveth and desireth to han a good name.'	when a man loves and desires to have a good name.'
I conseille yow that ye bigynne no werre in trust of youre richesses,	I advise you that you begin no war in trust of your riches,
but it lith in the wyl and in the hand of oure Lord God Almyghty.	but it lies in the will and in the hand of our Lord God Almighty.
therfore every man sholde greetly drede werres to bigynne.	therefore every man should greatly dread to begin wars.
"I see wel, dame Prudence, that by youre faire wordes and by youre resouns	"I see well, dame Prudence, that by your fair words and by your reasons
"A," quod Melibee, "now se I wel that ye loven nat myn honour ne my worshipe.	"A," said Melibee, "now see I well that you love not my honor nor my worthiness.
as I do myn owene, and evere have doon;	as I do my own, and ever have done;
And Salomon seith, `He that hath over-hard an herte, atte laste he shal myshappe and mystyde.'"	And Solomon says, `He that has over-hard a heart, at the last he shall have bad luck and suffer misfortune.'"
he shal fynde gretter grace than he that deceyveth hym by sweete wordes.'"	he shall find greater grace than he who deceives him by sweet words.'"
so manye faire resouns as ye putten to me and shewen.	so many fair reasons as you set forth and show to me.
he chaungeth the hertes of the mannes adversaries and constreyneth hem to biseken hym of pees and of grace.'	he changes the hearts of the man's adversaries and constrains them to beseech him for peace and for grace.'
and the grete harmes and perils that been in werre,	and the great harms and perils that are in war,
ye of youre grete goodnesse have presented unto us.	that you of your great goodness have presented unto us.
And therfore we oblige and bynden us and oure freendes for to doon al his wyl and his comandementz.	And therefore we pledge and bind us and our friends to do all his will and his commandments.
`ye peple, folk and governours of hooly chirche,	`you people, folk and governors of holy church,
Forthermoore I knowe wel and am right seur that he shal nothyng doon in this nede withouten my conseil,	Furthermore I know well and am very sure that he shall do nothing in this urgent matter without my advice,
knowelechynge ful lowely hir synnes and trespas, and how they were redy to suffren all peyne,	acknowledging very lowly their sins and trespass, and how they were ready to suffer any punishment,
Thanne was Prudence right glad and joyeful and seyde:	Then was Prudence very glad and joyful and said:
as it is aboven expressed and declared,	as it is above expressed and declared,
and abide nat ne delaye it nat til tomorwe.'	and abide not nor delay it not till tomorrow.'
yeldynge graces and thankynges to hir lord Melibee and to al his compaignye,	yielding thanks and gratitude to their lord Melibee and to all his company,
For ye han entred into myn hous by violence,	For you have entered into my house by violence,
that trewely we han disserved the deeth.	that truly we have deserved the death.
Thanne Melibee took hem up fro the ground ful benignely,	Then Melibee took them up from the ground very benignly,
"Certes," quod dame Prudence, "this were a crueel sentence and muchel agayn resoun.	"Certainly," said dame Prudence, "this would be a cruel sentence and much again reason.
but he shal also enforcen hym alwey to do somthyng by which he may renovelle his good name.	but he shall also strive always to do something by which he may renew his good name.
I seye ye mighte nat putten it to execucioun peraventure,	I say perhaps you could not put it to execution,
And I prey yow that ye wole forbere now to do vengeance,	And I pray you that you will forbear now to do vengeance,
dame Prudence, and hire wise informaciouns and techynges,	dame Prudence, and her wise counsels and teachings,
yet for as muche as I see and biholde youre grete humylitee	yet forasmuch as I see and behold your great humility
in the sighte of oure Lord God,	in the sight of our Lord God,
Or elles redden hem for hir plesaunce;	Or else read them for their pleasure;
Colours ne knowe I none, withouten drede,	Colors know I none, without doubt,
And many a labour, many a greet emprise,	And many a labor, many a great chivalric exploit,
To take hym for hir housbonde and hir lord,	To take him for her husband and hir lord,
That wolde he have for shame of his degree.	Which he would have to avoid bringing shame on his status (of knighthood).
That freendes everych oother moot obeye,	That friends must obey each other,
He is at his avantage al above.	He is in the best position, superior to all.
Wyn, wo, or chaungynge of complexioun	Wine, woe, or changing of the balance of bodily humors
Thus hath she take hir servant and hir lord --	Thus has she taken her servant and her lord --
Where as he lyveth in blisse and in solas.	Where he lives in bliss and in pleasure.
For al his lust he sette in swich labour --	For he set all his desire in such labor --
Hire freendes, whiche that knewe hir hevy thoght,	Her friends, who knew her gloomy thought,
So longe han they conforted hire til she	So long have they comforted her until she
And preyde hire on knees, for Goddes sake,	And prayed her on their knees, for God's sake,
But thanne was that a parcel of hire wo,	But then was that a portion of her woe,
Thanne wolde she sitte adoun upon the grene,	Then would she sit down upon the green,
Why han ye wroght this werk unresonable?	Why have you created this unreasonable work?
Toward mankynde; but how thanne may it bee	Toward mankind; but how then may it be
Were sonken into helle for his sake!	Were sunk into hell for his sake!
Unto a gardyn that was ther bisyde,	Unto a garden that was there nearby,
But if it were the verray paradys.	Unless it were the true paradise.
That was hir housbonde and hir love also.	Who was her husband and her love also.
Oon of the beste farynge man on lyve;	One of the most handsome men alive;
Withouten coppe he drank al his penaunce.	Copiously he drank all his penance (suffered intensely).
For Narcisus, that dorste nat telle hir wo.	For Narcissus, she who dared not tell her woe.
And was a man of worshipe and honour,	And was a man of good reputation and honor,
For wel I woot my servyce is in vayn;	For well I know my service is in vain;
But now, Aurelie, I knowe youre entente,	But now, Aurelius, I know your intention,
Looke what day that endelong Britayne	On whatever day that from end to end of Brittany
Lat swiche folies out of youre herte slyde.	Let such follies pass out of your heart.
Tho coome hir othere freendes many oon,	Then came her other friends many a one,
He seeth he may nat fro his deeth asterte;	He sees he can not escape from his death;
Of every plaunte, herbe, tree, and flour,	Of every plant, herb, tree, and flower,
Ye may me helpen, save my lady, best.	You can help me best (of anyone), except for my lady.
Right so the see desireth naturelly	Just so the sea desires naturally
And lat this flood endure yeres tweyne.	And let this flood-tide endure for two years.
To graunte me my sovereyn lady deere,	To grant me my sovereign lady dear,
His brother, which that knew of his penaunce,	His brother, who knew of his suffering,
The fresshe knyght, the worthy man of armes,	The vigorous knight, the worthy man of arms,
Two yeer and moore lay wrecche Aurelyus,	Two years and more lay wretched Aurelius,
But in his herte ay was the arwe kene.	But in his heart ever was the sharp arrow.
Particuler sciences for to lerne --	To learn specialized branches of learning --
As in oure dayes is nat worth a flye --	As in our days is not worth a fly --
For ofte at feestes have I wel herd seye	For often at feasts have I well heard say
"Now thanne conclude I thus: that if I myghte	"Now then conclude I thus: that if I might
Thanne were my brother warisshed of his wo;	Then my brother would be cured of his woe;
But if it were a two furlong or thre,	Not more than two or three furlongs,
For which he weep ful ofte many a teere.	For which he wept very often many a tear.
The gretteste that evere were seyn with ye.	The greatest that ever were seen with eye.
And whan this maister that this magyk wroughte	And when this master that wrought this magic
Sith I yow bad oure soper for to make,	Since I ordered you to make our supper,
And eek from Gerounde to the mouth of Sayne.	And also from Gironde to the mouth of Seine.
But looketh now, for no necligence or slouthe	But look now, for no negligence or laziness
And been descended ther they wolde abyde.	And are arrived where they would stay.
Janus sit by the fyr, with double berd,	Janus sits by the fire, with double beard,
That nyght and day he spedde hym that he kan	That night and day he worked as fast as he can
Of swich a supersticious cursednesse.	Of such a superstitious cursedness.
Fro the heed of thilke fixe Aries above,	From the head of that fixed Aries above,
For swiche illusiouns and swiche meschaunces	For such illusions and such evil practices
Doun to his maistres feet he fil anon,	Down to his mistress' feet he fell at once,
"Whom I moost drede and love as I best kan,	"Whom I most dread and love as I best know how,
Er ye me sleen by cause that I yow love.	Before you slay me because I love you.
Moore than to save myn hertes lyf right now --	More than to save my heart's life right now --
"Allas," quod she, "that evere this sholde happe!	"Alas," she said, "that ever this should happen!
But to hirself she spak, and seyde thus,	But to herself she spoke, and said thus,
Or knowe myselven fals, or lese my name;	Or know myself false, or lose my good name;
Al naked, to fulfille hir foul delit,	All naked, to fulfill their foul delight,
But was ther noon of al that compaignye	But there was none of all that company
Fro which ymage wolde she nevere go.	From which statue she would never go.
She took hir children alle, and skipte adoun	She took her children all, and leaped down
Mo than a thousand stories, as I gesse,	More than a thousand stories, as I guess,
I wol conclude that it is bet for me	I will conclude that it is better for me
The Theban mayden that for Nichanore	The Theban maiden that for Nichanore
Lo, which a wyf was Alceste," quod she.	Lo, what a wife was Alcestis," she said.
Honured is thurgh al the Barbarie.	Honored is through all heathendom.
And she gan wepen ever lenger the moore.	And she began to weep, ever the longer (she wept) the more (she wept) .
"Ye, wyf," quod he, "lat slepen that is stille.	"Yes, wife," he said, "let sleep that which is still.
That nevere, whil thee lasteth lyf ne breeth,	That never, while thy life or breath lasts,
He nolde no wight tellen his entente.	He would no person tell his intention.
Amydde the toun, right in the quykkest strete,	Amidst the town, right in the busiest street,
"Unto the gardyn, as myn housbonde bad,	"Unto the garden, as my husband commanded,
That fro his lust yet were hym levere abyde	That he would rather yet refrain from his desire
Than I departe the love bitwix yow two.	Than I should break apart the love between you two.
On Dorigen remembreth, atte leeste.	Remember Dorigen, at the least.
In sovereyn blisse leden forth hir lyf.	In perfect bliss lead forth their life.
I se namoore but that I am fordo.	I see no more but that I am ruined.
And broghte gold unto this philosophre,	And brought gold unto this scientist,
Two yeer or thre for to respiten me,	To grant me a respite for two years or three,
Aurelius his tale anon bigan,	Aurelius his tale immediately began,
She nevere erst hadde herde speke of apparence.	She never before had heard tell of illusion.
As wel as any of yow, it is no drede!	As well as any of you, it is no doubt!
Which was the mooste fre, as thynketh yow?	Which was the most free, as it seems to you?
`Ne bryng nat every man into thyn hous,'	`Do not bring every man into thy house,'
A tale of me, that am a povre man,	A tale by me, who am a poor man,
That they han eten with thy stubbel goos,	Which they have eaten with thy stubble-fed goose,
But nathelees I wol nat telle it yit;	But nonetheless I will not tell it yet;
Dauncen he koude so wel and jolily	He could dance so well and jollily
And daunced wel, he wolde nat come ayeyn --	And danced well, he would not come back--
For often tyme he foond his box ful bare.	For many times he found his cash box completely bare.
Til he were ny out of his prentishood,	Until he was nearly out of his apprenticeship,
Than he shende alle the servantz in the place.	Than that he should ruin all the servants in the place.
That lovede dys, and revel, and disport,	Who loved dicing, and revelling, and having fun,
That wole awake oure felawe al bihynde?	That will awake our fellow far behind us?
Hastow had fleen al nyght, or artow dronke?	Hast thou had fleas all night, or art thou drunk?
Which that heere rideth in this compaignye,	Who rides here in this company,
Hoold cloos thy mouth, man, by thy fader kyn!	Keep thy mouth closed, man, by thy father's kin!
And on the Manciple he gan nodde faste	And on the Manciple he began to shake his head fast
"By cause drynke hath dominacioun	"Because drink has domination
In liftyng up his hevy dronken cors.	In lifting up his heavy drunken body.
So myghte he lightly brynge me in the snare.	In that way he could easily bring me into the trap.
And certeynly, to tellen as it was,	And certainly, to tell it as it was,
For that wol turne rancour and disese	For that will turn rancor and strife
As olde bookes maken mencioun,	As old books make mention,
Certes the kyng of Thebes, Amphioun,	Certainly the king of Thebes, Amphioun,
As wel in fredom as in chivalrie,	As well in generosity as in chivalry,
Therwith in al this world no nyghtyngale	Therewith in all this world no nightingale
And so is every wight in swich degree;	And so is every person in such a situation;
This worthy Phebus dooth al that he kan	This worthy Phoebus does all that he can
Of alle deyntees that thou kanst bithynke,	Of all dainties that thou can imagine,
And tendre flessh, and make his couche of silk,	And tender meat, and make his couch of silk,
In tyme whan hir lust to han a make.	In time when she lusts to have a mate.
This Phebus, which that thoghte upon no gile,	This Phoebus, who thought upon no guile,
Foryeveth it me, and that I yow biseche.	Forgive it me, and that I you beseech.
If it so be they werke bothe amys --	If it so be they work both amiss --
To Alisaundre was toold this sentence,	To Alexander was told this sentence,
I wol noght telle of textes never a deel;	I will tell nothing of texts, never a bit;
That to myn herte it was a rejoysynge	That to my heart it was a rejoicing
For on thy bed thy wyf I saugh hym swyve."	For on thy bed I saw him copulate with thy wife."
This is th' effect; ther is namoore to sayn;	This is the substance of it; there is no more to say;
Now listow deed, with face pale of hewe,	Now liest thou dead, with face pale of hue,
And beeth avysed wel and sobrely	And be advised well and soberly
And eek thy white fetheres everichon,	And also thy white feathers every one,
And eek his speche, and out at dore hym slong	And also his speech, and out the door slung him
But, as I seyde, I am noght textueel.	But, as I said, I am not learned.
Hath many a man been spilt, as clerkes teche,	Has many a man been ruined, as clerks teach,
Ther lasse spekyng hadde ynough suffised,	Where less speaking had well enough sufficed,
My sone, spek nat, but with thyn heed thou bekke.	My son, speak not, but with thy head thou nod.
Though hym repente, or be hym nevere so looth.	Though he repent, or be ever so unwilling (it be known).
The ferthe part, and half an houre and moore,	One fourth, and half an hour and more,
And for that day, as in that latitude,	And for that day, in that latitude,
As dooth the streem that turneth nevere agayn,	As does the stream that never turns back,
"Sire Man of Lawe," quod he, "so have ye blis,	"Sir Man of Law," said he, "as you may have bliss,
For swich lawe as a man yeveth another wight,	For such law as a man gives another person,
For he hath toold of loveris up and doun	For he has told of lovers up and down
Of Lucresse, and of Babilan Tesbee;	Of Lucretia, and Thisbe of Babylon;
Thy litel children hangynge by the hals,	Thy little children hanging by the neck,
Birafte his doghter of hir maydenhede,	Deprived his daughter of her maidenhead,
Methamorphosios woot what I mene;	Metamorphoses shows what I mean;
If thou noon aske, with nede artow so woundid	If thou ask for none, thou art so wounded by need
For he noght helpeth needfulle in hir neede."	For he helps not the needy in their need."
O riche marchauntz, ful of wele been yee,	O rich merchants, full of prosperity are you,
Nere that a marchant, goon is many a yeere,	Were it not that a merchant, gone by is many a year,
Now fil it that the maistres of that sort	Now it happened that the masters of that company
Of the Emperoures doghter, dame Custance,	Of the Emperor's daughter, Lady Custance,
And wolde she were of al Europe the queene.	And would she were of all Europe the queen.
Thise marchantz han doon fraught hir shippes newe,	These merchants have had their ships newly loaded,
Tidynges of sondry regnes, for to leere	News from various countries, to learn
Which that men clepe the hevene ywriten was	Which men call the heaven was written
Of Sampson, Turnus, and of Socrates	Of Sampson, Turnus, and of Socrates
Diverse men diverse thynges seyden;	Different men said different things;
Bitwene hir bothe lawes, that they sayn	Between their two religions, that they say
For in this wo I may nat longe endure."	For in this woe I can not long endure."
And he shal han Custance in mariage,	And he shall have Custance in marriage,
May no man tellen in a litel clause	No man can tell in a brief statement
I seye, the woful day fatal is come,	I say, the woeful fatal day is come,
Of oon, she knoweth nat his condicioun?	By one, (of whom) she knows not his character?
"Allas, unto the Barbre nacioun	"Alas, unto the pagan world
That Romayns hath venquysshed tymes thre,	Who has vanquished Romans three times,
That crueel Mars hath slayn this mariage.	That cruel Mars has slain this marriage.
Is no tyme bet than oother in swich cas?	Is no time better than another in such a case?
And forth I lete hire saille in this manere,	And forth I let her sail in this manner,
How that my sone in point is for to lete	How my son is about to forsake
But, lordes, wol ye maken assurance,	But, lords, will you make assurance,
"We shul first feyne us cristendom to take --	"We shall first pretend to receive Christendom --
Lik to the serpent depe in helle ybounde!	Like the serpent deep in hell bound!
Makestow of wommen, whan thou wolt bigile.	Makest thou of women, when thou wilt deceive.
"To plesen hem I wol do my labour."	"To please them I will work hard."
And preyde hire for to ryde agayn the queene,	And prayed her to ride to meet the queen,
Of which that Lucan maketh swich a boost,	Of which Lucan makes such a boastful account,
The fruyt of this matiere is that I telle.	The essential part of this matter is what I tell.
O sodeyn wo, that evere art successour	O sudden woe, that ever art successor
But it were oonly dame Custance allone.	Except for only Lady Custance alone.
Out of Surrye agaynward to Ytaille.	Out of Syria back to Italy.
"O cleere, o welful auter, hooly croys,	"O clear, o blessed altar, holy cross,
On which thy lymes feithfully extenden,	Over which thy limbs faithfully extend,
Eek at the feeste? Who myghte hir body save?	Also at the feast? Who could save her body?
Dooth thyng for certein ende that ful derk is	Does something for a certain reason that is very obscure
Who bad the foure spirites of tempest	Who commanded the four spirits of tempest
Or in desert? No wight but Crist, sanz faille.	Or in desert? No person but Christ, without doubt.
The wyl of Crist was that she sholde abyde.	The will of Christ was that she should remain there.
The constable, whan hym lyst no longer seche,	The constable, when he desired no longer to search,
To serve and plesen everich in that place	To serve and please every one in that place
Alle Cristen folk been fled fro that contree	All Christian folk have fled from that country
That oon of hem was blynd and myghte nat see,	The one of them was blind and could not see,
"In name of Crist," cride this blinde Britoun,	"In the name of Christ," cried this blind Briton,
That helpeth folk out of the feendes snare."	That helps folk out of the fiend's snare."
But turne I wole agayn to my mateere.	But I will turn again to my subject.
And for despit he compassed in his thoght	And for malice he plotted in his mind
And leyde the blody knyf by dame Custance,	And laid the bloody knife by Lady Custance,
And eek the tyme, and where, and in what wise	And also the time, and where, and in what manner
But nathelees, ther was greet moornyng	But nonetheless, there was great mourning
Allas! Custance, thou hast no champioun,	Alas! Custance, thou hast no champion,
Marie I meene, doghter to Seint Anne,	Mary I mean, daughter to Saint Anne,
So stant Custance, and looketh hire aboute.	So stands Custance, and looks around her.
That from his eyen ran the water doun.	That from his eyes ran the water down.
And bothe his eyen broste out of his face	And both his eyes burst out of his face
Of hem that hadden wrong suspecioun	Of them that had a wrong suspicion
Made Alla wedden ful solempnely	Made Alla wed full solemnly
Me list nat of the chaf, ne of the stree,	I do not want of the chaff, nor of the straw,
Swiche manere necessaries as been plesynges	Such sorts of necessary acts as are pleasing
She halt hire chambre, abidyng Cristes wille.	She keeps to her chamber, abiding Christ's will.
And salueth hire ful faire in his langage:	And salutes her full fair in his language:
But heere al nyght I wol thou take thy reste.	But here all night I want that thou take thy rest.
Of so horrible a feendly creature	Of so horrible a fiendish creature
To me that am now lerned in his loore!	To me that am now learned in his teaching!
O messager, fulfild of dronkenesse,	O messenger, filled with drunkenness,
Lat hym enditen of thy traitorie!	Let him write about thy treachery!
Al nyght, til the sonne gan aryse.	All night, until the sun did arise.
He sholde putte, and croude hire fro the lond,	He should put, and push her from the land,
"Lord Crist," quod he, "how may this world endure,	"Lord Christ," said he, "how can this world endure,
Whan that the kyng this cursed lettre sente,	When the king this cursed letter sent,
As strong as evere he was, he is yet now.	As strong as ever He was, He is yet now.
"Mooder," quod she, "and mayde bright, Marie,	"Mother," said she, "and maiden bright, Mary,
Thow glorie of wommanhede, thow faire may,	Thou glory of womanhood, thou fair maiden,
So kys hym ones in his fadres name!"	Kiss him once in his father's name!"
And othere necessaries that sholde nede	And other necessities that should be needed
As ye han herd -- I kan telle it no bettre --	As you have heard -- I can tell it no better --
And al the venym of this cursed dede,	And all the venom of this cursed deed,
That fleteth in the see, in peyne and wo,	Who floats in the sea, in pain and woe,
Doun fro the castel comth ther many a wight	Down from the castle comes there many a person
For with hir struglyng wel and myghtily	For with her struggling well and mightily
To doon this synne, been outher slayn or shente!	To do this sin, are either slain or destroyed!
And to deliveren out of wrecchednesse	And to deliver out of wretchedness
Hath shapen, thurgh hir endelees goodnesse,	Has devised a plan, through her endless goodness,
His senatour, with roial ordinance,	His senator, with royal armaments,
Nothyng ne knew he what she was, ne why	In no way knew he who she was, nor why
The senatoures wyf hir aunte was,	The senator's wife was her aunt,
To Rome he comth to receyven his penance;	To Rome he comes to receive his penance;
As to doon any kyng a reverence.	As to do any king a reverence.
I may nat tellen every circumstance --	I can not tell every detail --
That I of woot" -- and shortly, in a stounde,	That I know of" -- and shortly, in a little while,
As possible is a creature to be.	As it is possible for a creature to be.
"What woot I if that Crist have hyder ysent	"What know I if Christ has hither sent
Whan Alla saugh his wyf, faire he hire grette,	When Alla saw his wife, gently he greeted her,
So wisly on my soule as have mercy,	As surely as they may have mercy on my soul,
I am so wery for to speke of sorwe.	I am so weary from speaking of sorrow.
That he wolde preye hir fader specially	That he would pray her father specially
Sente any child, but it is bet to deeme	To have sent any child, but it is better to believe
And eek his wyf, this Emperour to meete;	And also his wife, to meet this Emperor;
Now, goode fader, mercy I yow crye!	Now, good father, mercy I beg of you!
This child Maurice was sithen Emperour	This child Maurice was later Emperor
Wher as they lyve in joye and in quiete.	Where they live in joy and in quiet.
Lasteth the blisse of Alla with Custance.	Lasts the bliss of Alla with Custance.
Now is she scaped al hire aventure.	Now has she escaped all her adventure.
Joye after wo, governe us in his grace,	Joy after woe, govern us in his grace,
The Parson him answerde, "Benedicite!	The Parson him answered, "Bless me!
He schal no gospel glosen here ne teche.	He shall no gospel interpret here nor teach.
Ther is but litel Latyn in my mawe!"	There is but little Latin in my maw!"
So swatte that unnethe myghte it gon.	So sweated that it could hardly move.
I demed hym som chanoun for to be.	I judged him to be some sort of canon.
"God save," quod he, "this joly compaignye!	"God save," said he, "this jolly company!
"Freend, for thy warnyng God yeve thee good chaunce,"	"Friend, for thy telling him God give thee good luck,"
Ye wolde wondre how wel and craftily	You would wonder how well and craftily
He is a man of heigh discrecioun;	He is a man of great discretion;
That al this ground on which we been ridyng,	That all this ground on which we are riding,
His overslope nys nat worth a myte,	His outer garment is not worth a fraction of a penny,
And therfore keepe it secree, I yow preye.)	And therefore keep it secret, I pray you.)
"Syn of the konnyng of thy lord thow woost,	"Since thou knowest of the cunning of thy lord,
"Now," quod oure Hoost, "yit lat me talke to the.	"Now," said our Host, "yet let me talk to thee.
To muchel folk we doon illusioun,	To many folk we do delusion,
It wole us maken beggers atte laste."	It will make us beggars at the last."
"Hoold thou thy pees and spek no wordes mo,	"Hold thou thy peace and speak no more words,
"A!" quod the Yeman, "heere shal arise game;	"Ah!" said the Yeoman, "here shall arise some amusement;
For al my sorwe, labour, and meschief,	For all my sorrow, labor, and mischief,
With this Chanoun I dwelt have seven yeer,	With this Canon I have dwelt seven years,
And of my swynk yet blered is myn ye.	And by my work yet my eye is bleared.
For so helpe me God, therby shal he nat wynne,	For so help me God, he shall not profit thereby,
Whan we been there as we shul exercise	When we are where we shall exercise
That into poudre grounden been ful smal;	That are ground into very fine powder;
That we hadde in oure matires sublymyng,	That we had in purifying our materials,
Mowe in oure werkyng no thyng us availle,	Can in any way help us in our working,
As boole armonyak, verdegrees, boras,	Such as armenian bol (red clay), verdigris (copper acetate), borax,
As egremoyne, valerian, and lunarie,	Such as agrimony, valerian, and moonwort,
Sal tartre, alkaly, and sal preparat,	Potassium nitrate, alkali, and purified salt,
The foure spirites and the bodies sevene,	The four spirits and the seven metals
This cursed craft whoso wole excercise,	Whoever will exercise this cursed craft,
Preest or chanoun, or any oother wyght,	Priest or canon, or any other creature,
Ylike wel, whan they han al ydo;	Equally well, when they are all done;
For, as I trowe, I have yow toold ynowe	For, as I believe, I have told you enough
But that good hope crepeth in oure herte,	Except that good hope creeps into our heart,
Which that they myghte wrappe hem inne a-nyght,	Which they might wrap themselves in at night,
Lo, thus by smellyng and threedbare array,	Lo, thus by smelling and threadbare array,
Of metals with a certeyn quantitee,	With a specific quantity of metals,
But if they weren wroght of lym and stoon;	Unless they were made of lime and stone;
Whan that oure pot is broke, as I have sayd,	When our pot is broken, as I have said,
I kan nat telle wheron it was long,	I can not tell what it was due to,
And al this mullok in a syve ythrowe,	And all this rubbish thrown in a sieve
And somtyme comth it sauf unto the londe."	And sometime they come safely unto the land."
And whan we been togidres everichoon,	And when we are all together every one,
That shul ye knowe, er that I fro yow wende,	That shall you know, before I from you wend,
In all this world is not his equal in falsehood,	For in his termes he wol hym so wynde,
Not knowing of his false way of life.	And if yow list to yeve me audience,
But I mean to correct what is amiss.	This tale was nat oonly toold for yow,
If the prospect of shame or dishonor can cause any fear.	And beeth no thyng displesed, I yow preye,
That does not not matter; I will now proceed,	And tell forth my tale of the canon
This preest hym took a marc, and that as swithe,	This priest gave him a mark, and that very quickly,
That in no wise he breke wole his day;	That in no way will he fail to pay on his assigned day:
For gold ne silver that he to me lente,	For gold or silver that he lent to me,
That I wol doon a maistrie er I go."	That I will do a masterful work before I go."
That everemoore delit hath and gladnesse --	Who evermore has delight and gladness --
Which that this fox yshapen hath to thee!	Which this fox has destined for thee!
It was another chanoun, and nat hee,	It was another canon, and not he,
Consumed and wasted han my reednesse.	That have consumed and wasted my redness.
And wente hym forth, and cam anon agayn	And went forth, and came right back again
Taak in thyn hand, and put thyself therinne	Take in thy hand, and thyself put therein
Or elleswhere, and make it malliable;	Or elsewhere, and make it malleable;
Al as he bad fulfilled was in dede.	All was in deed fulfilled as he commanded.
Or somwhat elles, was nat worth a flye,	Or something else, that was not worth a fly,
Out of his bosom took a bechen cole,	Out of his bosom took a beech coal,
And so he dide, er that they wente atwynne;	And so he did, before they went apart;
The coles, as I tolde yow er this,	The coals, as I told you before this,
And leyde it above upon the myddeward	And laid it above, upon the middle
Syn it so evene above couched was.	Since it was placed so exactly above.
And bryngeth eek with yow a bolle or a panne	And bring also with you a bowl or a pan
And coome agayn withouten any delay.	And came back again without any delay.
So slyly that the preest it nat espide,	So slyly that the priest did not see it,
He putte his hand in and took up a teyne	He put his hand in and took up a small bar
The seconde tyme, that ye may taken heede	The second time, that you may pay attention
Comanded hym, and faste blew the fir,	Commanded him, and blew hard on the fire,
And whil this preest was in his bisynesse,	And while this priest was busy with his work,
But it a fool be, woot wel it moot nede,	Unless he be a fool, knows well it must by necessity,
"Though poure I be, crafty thou shalt me fynde.	"Though I be poor, thou shalt find me skilfull.
As ministre of my wit, the doublenesse	As servant of my wit, the duplicity
And caste in poudre, and made the preest to blowe,	And cast in powder, and made the priest to blow,
Unwityng this preest of his false craft,	This priest not knowing of his false craft,
This preest took up this silver teyne anon,	This priest quickly took up this silver bar,
But that they weren as hem oghte be.	But that they were as they ought to be.
And to the chanoun thus he spak and seyde:	And to the canon thus he spoke and said:
Sire, at o word, if that thee list it have,	Sir, at one word, if thou want to have it,
And, as ye love me, kepeth it secree.	And, as you love me, keep it secret.
Quod the chanoun, "and farwel, grant mercy!"	Said the canon, "and farewell, many thanks!"
So ferforth that unnethes is ther noon.	So widespread that there is hardly any gold left.
A man may lightly lerne, if he have aught,	A man can easily learn, if he have anything,
Lest ye lese al; for bet than nevere is late.	Lest you lose all; for late is better than never.
For though ye looken never so brode and stare,	For though you look never so broadly and stare,
He seith right thus, withouten any lye:	He says right thus, without any lie:
That out of Sol and Luna were ydrawe.	That out of Sol (gold) and Luna (silver) were drawn.
As his book Senior wol bere witnesse,	As his book Senior will bear witness,
Of elementes foure," quod Plato.	Of the four elements," said Plato.
Men for t'enspire, and eek for to deffende	To enlighten men, and also to forbid
And there a poynt, for ended is my tale.	And there (put) a period, for my tale is ended.
Telle us som myrie tale, by youre fey!	Tell us some merry tale, by your faith!
Speketh so pleyn at this tyme, we yow preye,	Speak so plainly at this time, we pray of you,
He is now deed and nayled in his cheste;	He is now dead and nailed in his coffin;
"But forth to tellen of this worthy man	"But forth to tell of this worthy man
Taketh his firste spryngyng and his sours,	Takes its first springing and its source,
And obeisant, ay redy to his hond,	And obedient, ever ready to his hand (to do his commands),
Save in somme thynges that he was to blame;	Except in some things he was to blame;
That flokmeele on a day they to hym wente,	That in groups on one day they went to him,
Accepteth, lord, now of youre gentillesse	Grant, lord, now of your nobility
"For certes, lord, so wel us liketh yow	"For certainly, lord, so well you please us
And thenketh, lord, among youre thoghtes wyse	And think, lord, among your wise thoughts
Been of that day whan deeth shal on us falle.	Are of that day when death shall on us fall.
For if it so bifelle, as God forbede,	For if it so happen, may God forbid,
That seelde tyme is founde in mariage;	That seldom is found in marriage;
Unlyk hir worthy eldres hem bifore;	Unlike their worthy elders (who came) before them;
To worshipe hire, whil that hir lyf may dure,	To honor her, while her life may endure,
With hertely wyl they sworen and assenten	With heartfelt will they swore and assent
And they, with humble entente, buxomly,	And they, with humble good will, obediently,
To doon unto the feeste reverence.	To lend honor unto the feast.
But hye God somtyme senden kan	But high God sometimes can send
She drank, and for she wolde vertu plese,	She drank, and because she would satisfy the demands of virtue
Wortes or othere herbes tymes ofte,	Cabbages or other greens very often,
He noght with wantown lookyng of folye	He not with lecherous looking of folly
The day of weddyng cam, but no wight kan	The day of wedding came, but no person can
And of hir clothyng took he the mesure	And of her clothing he took the measure
That may be founde as fer as last Ytaille.	What can be found from as far as farthest Italy.
To fecchen water at a welle is went,	Has gone to fetch water at a well,
And thanne I may at leyser hire biholde,	And then I may at leisure her behold,
Ful sobrely, and seyde in this manere:	Full soberly, and said in this manner:
If that thou vouche sauf, what so bityde,	If thou agree, whatsoever may happen,
This sodeyn cas this man astonyed so	This sudden occurrence this man so astounded
For I wol axe if it hire wille be	For I will ask if it be her will
For nevere erst ne saugh she swich a sighte.	For never before saw she such a sight.
That I yow wedde, and eek it may so stonde,	That I you wed, and also it may so stand,
Neither by word ne frownyng contenance?	Neither by word nor frowning countenance?
And forth he gooth with a ful sobre cheere	And forth he goes with a full sober manner
To handle hir clothes, wherinne she was clad.	To handle her clothes, in which she was clad.
This markys hath hire spoused with a ryng	This marquis has espoused her with a ring
That it ne semed nat by liklynesse	That it seemed not likely
Hem thoughte she was another creature.	They thought she was another creature.
But eek biside in many a regioun,	But also moreover in many a region,
Was ofte vertu hid, the peple hym heelde	Was often virtue hid, the people considered him
If gentil men or othere of hire contree	If noble men or others of her country
For though a mayde child coome al bifore,	For though a maid child came all before,
He hadde assayed hire ynogh bifore,	He had tested her enough before,
And seyde thus: "Grisilde," quod he, "that day	And said thus: "Griselda," said he, "that day
Ther is no wight that hereth it but we tweye.	There is no person that hears it but we two.
But I desire, as I have doon bifore,	But I desire, as I have done before,
That ye me highte and swore in youre village	That you promised me and swore in your village
Liken to yow that may displese me;	Please you that may displease me;
Soone after this, a furlong wey or two,	Soon after this, in a few minutes,
"Madame," he seyde, "ye moote foryeve it me,	"Madame," he said, "you must forgive it me,
As though he wolde han slayn it er he wente.	As if he would have slain it before he went.
Conformynge hire to that the markys lyked.	Conforming herself to what the marquis pleased.
But sith I thee have marked with the croys	But since I have marked thee with the cross
And to the sergeant mekely she sayde,	And to the sergeant meekly she said,
And of Grisildis wordes and hire cheere	And of Griselda's words and her manner
But, upon peyne his heed of for to swappe,	But, upon pain of having his head cut off,
The sergeant gooth, and hath fulfild this thyng;	The sergeant goes, and has fulfilled this order;
Ne of hir doghter noght a word spak she.	Nor of her daughter not a word spoke she.
Was for this child, and God they thanke and herye.	Was for this child, and God they thank and praise.
And namely sith my sone yboren is,	And especially since my son is born,
For certeinly I drede swich sentence,	For certainly I dread such opinion,
I wol no thyng, ne nyl no thyng, certayn,	I want nothing, nor will not want any thing, certainly,
"Lefte I my wyl and al my libertee,	"Left I my will and all my liberty,
"Deth may noght make no comparisoun	"Death can not make any comparison (is nothing compared)
Hath hent hire sone, that ful was of beautee.	Has seized her son, that was full of beauty.
But to Boloigne he tendrely it broghte.	But to Bologna he tenderly brought it.
But now of wommen wolde I axen fayn	But now I would like to ask of women
Right so this markys fulliche hath purposed	Right so this marquis has firmly decided
Ther nas but o wyl, for as Walter leste,	There was but one will, for as Walter desired,
Swich murmur was among hem comunly.	Such grumbling was among them unanimously.
Whan that his doghter twelve yeer was of age,	When his daughter was twelve years of age,
As by the popes dispensacion,	As by the pope's dispensation,
The adversitee of Fortune al t'endure,	To endure all the adversity of Fortune,
To bryngen hoom agayn his children two	To bring home again his two children
In riche array, this mayden for to gyde,	In rich array, this maiden to guide,
Meanwhile, in accord with his wicked usage,	This markys, yet his wyf to tempte moore
Not for your lineage, nor for your riches;	But now knowe I in verray soothfastnesse
My new wife is coming by the way.	"Be strong of herte, and voyde anon hir place;
How between your magnificence	And my poverte no wight kan ne may
And ever shall, while my life may endure,	Aboven every worldly creature.
Until I be dead I will lead my life there,	A wydwe clene in body, herte, and al.
For since it pleases you, my lord," said she,	"That whilom weren al myn hertes reste,
"But sooth is said -- always I find it true,	For in effect it preeved is on me --
To you I brought nothing else, beyond doubt,	But feith, and nakednesse, and maydenhede;
That I should go without a smock out of your palace.	"Ye koude nat doon so dishonest a thyng,
Condescend to give me, as my recompense,	But swich a smok as I was wont to were,
And in her smock, with head and foot all bare,	Toward hir fadre hous forth is she fare.
Was ever in suspicion of her marriage;	For evere he demed, sith that it bigan,
But on her body he could not bring it,	For rude was the clooth, and moore of age
No wonder is, for in her great estate	Hire goost was evere in pleyn humylitee;
Though clerks praise women but a little,	Ther kan no man in humblesse hym acquite
Such a noble array in all West Lombardy.	The markys, which that shoop and knew al this,
Be received to-morrow as royally	As it possible is in myn hous to be,
Though thy dress be bad and in poor condition,	Do thou thy devoir at the leeste weye."
And to set tables, and make beds;	And peyned hire to doon al that she myghte,
And then for the first time amongst themselves they say	That Walter was no fool, thogh that hym leste
"O stormy people! Inconstant and ever untrue!	Ay undiscreet and chaungynge as a fane!
To have a new lady of their town.	Namoore of this make I now mencioun,
And after that carries on her work.	With so glad chiere his gestes she receyveth,
With all her heart, in full benign intention,	So wel that no man koude hir pris amende.
And so I hope that he will to you send	Plesance ynogh unto youre lyves ende.
Her glad expression, and no malice at all,	And he so ofte had doon to hire offence,
In great estate and in poverty.	Now knowe I, dere wyf, thy stedfastnesse" --
"This is thy daughter, which thou hast supposed	To be my wyf; that oother feithfully
But to test in thee thy womanhood,	And nat to sleen my children -- God forbeede! --
She bathed both their visage and their hair.	O which a pitous thyng it was to se
That cruel hounds or some foul animal pests	Hadde eten yow; but God of his mercy
Down ran of them that stood beside her;	Unnethe abouten hire myghte they abyde.
Have taken her and into chamber they go,	And strepen hire out of hire rude array,
For more splendid in every man's sight	This feste was, and gretter of costage,
His son succeeds in his heritage	In reste and pees, after his fader day,
But so that every person, in his station in life,	Sholde be constant in adversitee
He tests folk all the time, it is no doubt,	And suffreth us, as for oure excercise,
In all the town Griseldas three or two;	For if that they were put to swiche assayes,
And let us stint of serious matter.	Herkneth my song that seith in this manere:
Let no humility nail down your tongue,	Ne lat no clerk have cause or diligence
Since it may work to the benefit of all.	Ye archewyves, stondeth at defense,
Shall pierce his breast and also his neck-guard.	In jalousie I rede eek thou hym bynde,
Oure Hooste seyde, and swoor, "By Goddes bones,	Our Host said, and swore, "By God's bones,
The gold of hem hath now so badde alayes	The gold of them has now been so badly debased
Grisilde is deed, and eek hire pacience,	Griselda is dead, and also her patience,
As of Grisildis pacient and kynde,	As of patient and kind Griselda,
Ne suffreth nat that men yow doon offense.	Suffer not that men do offense to you.
If thou be fair, ther folk been in presence,	If thou be fair, where folk are present,
My wyf at hoom had herd this legende ones!	My wife at home had heard this legend once!
Whereas men han been in greet welthe and ese,	When men have been in great wealth and ease,
He spak how Fortune covered with a clowde	He spoke of how Fortune covered with a cloud
Wherfore, sire Monk, daun Piers by youre name,	Therefore, Sir Monk, dan Piers by your name,
Noght helpeth it to tellen his sentence.	It is no use to tell his opinion.
Be blithe, though thou ryde upon a jade.	Be happy, though thou ride upon a nag.
Was whilom dwellyng in a narwe cotage,	Was once dwelling in a small cottage,
Ful sooty was hire bour and eek hir halle,	Full sooty was her bedchamber and also her hall,
No wyn ne drank she, neither whit ne reed;	No wine she drank, neither white nor red;
On messe-dayes that in the chirche gon.	That goes in the church on mass-days.
Lyk asure were his legges and his toon;	Like azure were his legs and his toes;
And compaignable, and bar hyrself so faire	And companionable, and bore herself so fair
And so bifel that in a dawenynge,	And so befell that in a dawning,
And he answerde, and seyde thus: "Madame,	And he answered, and said thus: "Madame,
His colour was bitwixe yelow and reed,	His color was between yellow and red,
For certes, what so any womman seith,	For certainly, whatever any woman says,
Nothyng, God woot, but vanitee in sweven is.	Nothing, God knows, but foolishness is in dreams.
Of contek, and of whelpes, grete and lyte;	Of strife, and of dogs, big and little;
"Now sire," quod she, "whan we flee fro the bemes,	"Now sir," said she, "when we fly from the beams,
The whiche han of hire propretee by kynde	The which by nature have the power
Of wormes, er ye take youre laxatyves	Of worms, before you take your laxatives
That hath of wysdom swich a greet renoun,	That has of wisdom such a great renown,
Ther nedeth make of this noon argument;	There need be no argument about this;
Wherfore they mosten of necessitee,	Therefore they must of necessity,
This man mette in his bed, ther as he lay,	This man dreamed in his bed, where he lay,
Thus twies in his slepyng dremed hee;	Thus twice in his sleeping he dreamed;
And tolde hym every point how he was slayn,	And told him in full detail how he was slain,
"This man gan fallen in suspecioun,	"This man began to fall in suspicion,
And in this carte he lith gapyng upright.	And in this cart he lies gaping upright.
Mordre wol out; that se we day by day.	Murder will out; we see that day by day.
And were anhanged by the nekke-bon.	And were hanged by the neck-bone.
But on a day, agayn the even-tyde,	But on a day, toward the evening time,
Thow shalt be dreynt; my tale is at an ende.'	Thou shalt be drowned; my tale is at an end.'
Men dreme alday of owles and of apes,	Men dream all the time of owls and of apes,
And ship and man under the water wente	And ship and man went under the water
Of Mercenrike, how Kenelm mette a thyng.	Of Mercia, how Kenelm dreamed a thing.
"Dame Pertelote, I sey yow trewely,	"Dame Pertelote, I say you truly,
Warnynge of thynges that shul after falle.	Warnings of things that shall afterward befall.
That day that Ector sholde lese his lyf,	That day that Hector should lose his life,
That I shal han of this avisioun	That I shall have of this vision
It maketh al my drede for to dyen;	It makes all my dread die;
And with that word he fley doun fro the beem,	And with that word he flew down from the beam,
He chukketh whan he hath a corn yfounde,	He clucks when he has found a seed,
His sevene wyves walkynge by his syde,	His seven wives walking by his side,
And se the fresshe floures how they sprynge;	And see the fresh flowers, how they spring;
As is the book of Launcelot de Lake,	As is the Book of Lancelot of the Lake,
Til it was passed undren of the day,	Until it had passed  a.m. of the day,
Thou were ful wel ywarned by thy dremes	Thou were very well warned by thy dreams
Or Boece, or the Bisshop Bradwardyn,	Or Boethius, or the Bishop Bradwardyn,
My tale is of a cok, as ye may heere,	My tale is of a cock, as you may hear,
Passe over, for I seyde it in my game.	Pass over, for I said it as a joke.
How that they syngen wel and myrily).	How they sing well and merrily).
This Chauntecleer, whan he gan hym espye,	This Chauntecleer, when he did espy him,
As any aungel hath that is in hevene.	As has any angel that is in heaven.
As dide youre fader in the morwenynge.	As did your father in the morning.
I have wel rad in `Daun Burnel the Asse,'	I have well read in `Dan Burnel the Ass,'
This Chauntecleer his wynges gan to bete,	This Chauntecleer began to beat his wings,
Strecchynge his nekke, and heeld his eyen cloos,	Stretching his neck, and held his eyes closed,
O Venus, that art goddesse of plesaunce,	O Venus, who art goddess of pleasure,
For on a Friday, soothly, slayn was he.	For on a Friday, truly, he was slain.
But sovereynly dame Pertelote shrighte	But supremely dame Pertelote shrieked
For that hir husbondes losten alle hir lyves --	Because their husbands lost all their lives --
And eek with staves many another man.	And also with staves many another man.
Out of the hyve cam the swarm of bees.	Out of the hive came the swarm of bees.
Now, goode men, I prey yow herkneth alle:	Now, good men, I pray you all to listen:
Maugree youre heed, the cok shal heere abyde.	Despite all you could do, the cock shall here remain.
Whan I yow hente and broghte out of the yerd.	When I seized you and brought you out of the yard.
Al wilfully, God lat him nevere thee!"	All willfully, God let him never prosper!"
To oure doctrine it is ywrite, ywis;	Is written for our instruction, indeed;
For if thou have corage as thou hast myght,	For if thou have as much desire as thou hast might,
Seide unto another, as ye shuln heere.	Said unto another, as you shall hear.
Ye han seyd muche thyng right wel, I seye;	You have said many things right well, I say;
A somonour is a rennere up and doun	A summoner is a runner up and down
I shal hym tellen which a greet honour	I shall tell him what a great honor
An erchedeken, a man of heigh degree,	An archdeacon, a man of high rank,
And smale tytheres weren foule yshent,	And those who paid less than full tithes were severely punished,
A slyer boye nas noon in Engelond;	No one in England was a more clever rascal;
"Peter! so been wommen of the styves,"	"By St. Peter! so are women of the brothels,"
For hire acqueyntance was nat come of newe.	For their acquaintance was not come recently.
His maister hadde but half his duetee.	His master had but half the amount due to him.
And pile the man, and lete the wenche go.	And rob the man, and let the wench go.
Or an avowtier, or a paramour.	Or an adulterer, or a concubine.
He hadde upon a courtepy of grene,	He had upon him a short jacket of green,
"Artow thanne a bailly?" "Ye," quod he.	"Art thou then a bailiff?" "Yes," said he.
Al shal be thyn, right as thou wolt desire."	All shall be thine, just as thou wilt desire."
This yeman hym answerde in softe speche,	This yeoman him answered in gentle words,
And spareth nat for conscience ne synne,	And spare not for conscience nor sin,
Fro yeer to yeer I wynne al my dispence.	From year to year I earn all my expenses.
I shrewe thise shrifte-fadres everychoon.	I curse these confessors every one.
Looke how thou rydest for the same entente,	Look how thou ridest for the same purpose,
But whan us liketh we kan take us oon,	But when we like we can take us one,
As moost able is oure preyes for to take."	As are most suitable for taking our prey."
But, for thou axest why labouren we --	But, since thou askest why labor we --
And somtyme han we myght of bothe two --	And sometimes have we power over both of the two --
As to the erchebisshop Seint Dunstan,	As to the archbishop Saint Dunstan,
I do no fors of youre dyvynytee.)	I put no store in your theology.)
Til it be so that thou forsake me."	Until it be that thou forsake me."
And I shal myn; thus may we bothe lyve.	And I shall mine; thus may we both live.
The cartere smoot and cryde as he were wood,	The carter smote and cried as if he were crazy,
Herestow nat how that the cartere seith?	Hearest thou not what the carter says?
And al his handwerk, bothe moore and lesse!	And all his handiwork, both more and less!
This somonour to his brother gan to rowne:	This summoner to his brother began to whisper:
"Com out," quod he, "thou olde virytrate!	"Come out," said he, "thou old hag!
I have been syk, and that ful many a day.	I have been sick, and that full many a day.
Com of, and lat me ryden hastily;	Hurry up, and let me ride hastily;
"Allas!" quod she, "God woot, I have no gilt."	"Alas!" said she, "God knows, I have no guilt."
Unto the devel blak and rough of hewe	Unto the devil black and rough of appearance
For any thyng that I have had of thee.	For any thing that I have had of thee.
And God, that maked after his ymage	And God, that made after his image
The peynes of thilke cursed hous of helle.	The pains of that cursed house of hell.
For Crist wol be youre champion and knyght.	For Christ will be your champion and knight.
Have me excused if I speke amys;	Have me excused if I speak amiss;
Hym lakked noght that longeth to a kyng.	He lacked nothing that is appropriate to a king.
And kept alwey so wel roial estat	And always so well maintained the splendor appropriate to his rank
I dar nat undertake so heigh a thyng.	I dare not undertake so high a thing.
Doon cryen thurghout Sarray his citee,	Proclaimed throughout Sarray his city,
Hem semed han geten hem protecciouns	They seemed to have gotten themselves protections
At every cours the ordre of hire servyse.	At every course the order of their service.
And so bifel that after the thridde cours,	And so it befell that after the third course,
In al the halle ne was ther spoken a word	In all the hall there was not spoken a word
Though he were comen ayeyn out of Fairye,	Though he were come again out of Fairyland,
Ne kan nat clymben over so heigh a style,	Nor can not climb over so high a stile,
Kan in the space of o day natureel --	Can in the space of one natural day --
Though that ye slepen on his bak or reste,	Though you sleep or rest on his back,
And openly who is youre freend or foo.	And clearly who is your friend or foe.
"The vertu of the ryng, if ye wol heere,	"The power of the ring, if you will hear,
"This naked swerd, that hangeth by my syde,	"This naked sword, that hangs by my side,
This is a verray sooth, withouten glose;	This is a very truth, without lying;
And born anon into the heighe tour	And carried straightway into the high tower
And therfore in the place they han it laft	And therefore in the place they have it left
For certes, fro his tayl unto his ere	For certainly, from his tail unto his ear
Rehersynge of thise olde poetries,	Retelling these old poems,
Another rowned to his felawe lowe,	Another whispered to his fellow quietly,
That born was up into the maister-tour,	That was carried up into the principal tower,
And oother folk han wondred on the swerd	And other folk have wondered on the sword
Which is unknowe, algates unto me.	Which is unknown, at least unto me.
But, for they han yknowen it so fern,	But, because they have known it so long,
Whan that this Tartre kyng, Cambyuskan,	When this Tarter king, Cambyuskan,
This strange knyght is fet to hym ful soone,	This foreign knight is fetched to him right away,
For drede of jalouse mennes aperceyvynges?	For dread of jealous men's perceptions?
Unto the temple, as reson was, they wende.	Unto the temple, as was reasonable, they wend.
That syn the grete sege of Troie was,	That since the great siege of Troy was,
Ye mooten trille a pyn, stant in his ere,	You must turn a peg, which stands in his ear,
He shal nat thennes been ydrawe ne ybore.	He shall not thence be drawn nor carried away.
And hath conceyved in his wit aright	And has correctly understood
Til wel ny the day bigan to sprynge.	Until well nigh the day began to spring.
As sleep hem bad; they tooke it for the beste.	As sleep them bad; they took it for the best.
Ne on the morwe unfeestlich for to se,	Nor in the morning to appear unfestive,
Thise olde wommen that been gladly wyse,	These old women who are customarily wise,
That in the Ram is foure degrees up ronne --	That in the Ram is four degrees up run --
That it made alle hire hertes for to lighte,	That it made all their hearts to lighten,
And by the same resoun, thynketh me,	And by the same reason, it seems to me,
Ran endelong the tree ther-as she stood.	Ran down the length of the tree in which she stood.
As wel of plumage as of gentillesse	As well in plumage as in nobility
And koude answeren hym in his ledene ageyn,	And could answer him in his language in return,
Unto the hauk, as ye shal after heere:	Unto the hawk, as you shall after hear:
Moot been enchesoun of youre cruel dede,	Must be the reason for your cruel deed,
If that I verraily the cause knewe	If that I truly knew the cause
Unto the tyme she gan of swough awake.	Until the time she awoke from the swoon.
Of verray wommanly benignytee	Out of true womanly goodness
That oother weep as she to water wolde	That other wept as she would turn to water
Al were he ful of treson and falsnesse,	Although he was full of treason and falseness,
And kepeth in semblaunt alle his observaunces	And keeps in outward appearance all his observances
Al innocent of his crouned malice,	Entirely ignorant of his consummate malice,
But sooth is seyd, goon sithen many a day,	But truly it is said, since many a day gone by,
So lyk a gentil lovere of manere,	So like a gentle lover in his manners,
Ther doublenesse or feynyng sholde approche,	Where duplicity or feigning were concerned,
Me thoughte I felte deeth myn herte twiste.	It seemed to me I felt death twist my heart.
But finally, thus atte laste it stood,	But finally, thus at the last it stood,
That he had felt as muche harm as I,	That he had felt as much harm as I,
And took hym by the hond, Seint John to borwe,	And took him by the hand, with Saint John as my guarantor,
Whan it cam hym to purpos for to reste,	When he decided to rest,
He with his feet wol spurne adoun his cuppe,	He with his feet will kick down his cup,
That al his love is clene fro me ago,	That all his love is completely gone from me,
And softely in plastres gan hire wrappe,	And softly did wrap her in bandages,
And al withoute, the mewe is peynted grene,	And on all the outside, the pen is painted green,
By mediacion of Cambalus,	By the mediation of Cambalus,
Ne hadde he ben holpen by the steede of bras;	Had he not been helped by the steed of brass;
So feelyngly thou spekest, sire, I allow the!	With such feeling thou speakest, sir, I praise thee!
As that ye been! Fy on possessioun,	As you are! Fie on possessions,
"What, Frankeleyn! Pardee, sire, wel thou woost	"What, Franklin! By God, sir, well thou knowest
As fer as that my wittes wol suffyse.	So far as my mental abilities will suffice.
He conquered al the regne of Femenye,	He conquered all the land of the Amazons,
I wolde have toold yow fully the manere	I would have told you fully the manner
I have, God woot, a large feeld to ere,	I have, God knows, a large field to till,
He was war, as he caste his eye aside,	He was aware, as he cast his eye aside,
Perturben so my feste with criynge?"	So disturb my festival with crying?"
Victorie, and as a conqueror to lyven,	Victory, and (allowed) to live as a conqueror,
That noon estaat assureth to be weel.	Who assures no estate (will continue) to be well.
We losten alle oure housbondes at that toun,	We lost all our husbands at that town,
Neither to been yburyed nor ybrent,	Neither to be buried nor burned,
That whilom weren of so greet estaat;	That once were of such high rank;
His baner he desplayeth, and forth rood	He displays his banner, and rode forth
So shyneth in his white baner large	So shines in his large white banner
With Creon, which that was of Thebes kyng,	With Creon, who was king of Thebes,
That the ladyes made at the brennynge	That the ladies made at the burning
Hem for to strepe of harneys and of wede,	To strip them of armor and of clothing,
But by hir cote-armures and by hir gere	But by their coats of arms and by their equipment
He took his hoost, and hoom he rit anon	He took his army, and home he rides straightway
Than is the lylie upon his stalke grene,	Than is the lily upon its green stalk,
This maked Emelye have remembraunce	This made Emelye remember
The grete tour, that was so thikke and stroong,	The great tower, that was so thick and strong,
In which he al the noble citee seigh,	In which he saw all the noble city,
Of iren greet and square as any sparre,	Of iron, great and square as any beam,
Fortune hath yeven us this adversitee.	Fortune has given us this adversity.
But I was hurt right now thurghout myn ye	But I was hurt right now through my eye
Bifore me, sorweful, wrecched creature,	Before me, sorrowful, wretched creature,
Arcite is hurt as muche as he, or moore.	Arcite is hurt as much as he, or more.
"Nay," quod Arcite, "in ernest, by my fey!	"Nay," said Arcite, "in earnest, by my faith!
Ne in noon oother cas, my leeve brother,	Nor in any other case, my dear brother,
I loved hire first, and tolde thee my wo	I loved hire first, and told thee my woe
What wiltow seyen? Thou woost nat yet now	What wilt thou say? Thou knowest not yet now
Than may be yeve to any erthely man;	Than may be given to any earthly man;
Perpetuelly; us gayneth no raunsoun.	Perpetually; no ransom can help us.
And everich of us take his aventure."	And each one of us take his chance."
For in this world he loved no man so,	For in this world he loved no man so (much),
Duc Theseus hym leet out of prisoun	Duke Theseus let him out of prison
Ther nas noon oother remedie ne reed;	There was no other remedy nor course of action;
Noght in purgatorie, but in helle.	Not in purgatory, but in hell.
Ful blisfully in prison maistow dure --	Very blissfully in prison thou can remain --
That ther nys erthe, water, fir, ne eir,	That there is not earth, water, fire, nor air,
That cause is of his mordre or greet siknesse;	Which is the cause of his murder or great sickness;
We seken faste after felicitee,	We seek eagerly after felicity,
Whan that he wiste Arcite was agon,	When he knew Arcite was gone,
Assemblen alle the folk of oure kynrede,	Assemble all the folk of our family,
With al the wo that prison may me yive,	With all the woe that prison may give me,
Youre parlement and youre eterne graunt,	Your decision and your eternal decree,
That man is bounden to his observaunce,	That man is bound to his duty,
That many a trewe man hath doon mescheef,	That has done mischief to many a true man,
And of Arcita forth I wol yow telle.	And of Arcite forth I will tell you.
Ne nevere mo ne shal his lady see.	Nor nevermore shall see his lady.
Ful ofte a day he swelte and seyde "Allas!"	Very often each day he grew faint and said "Alas!"
And waillynge al the nyght, makynge his mone;	And wailing all the night, making his moan;
Biforen, in his celle fantastik.	In the front lobe, in his imagination.
Biforn hym stood and bad hym to be murie.	Stood before him and commanded him to be merry.
Ne for the drede of deeth shal I nat spare	Nor shall I refrain for the dread of death
Lyve in Atthenes everemoore unknowe,	Live in Athens evermore unknown,
To drugge and drawe, what so men wol devyse.	To drudge and draw water, whatever men will command.
A yeer or two he was in this servyse,	A year or two he was in this service,
Ther as he myghte his vertu excercise.	Where he could exercise his abilities.
And thre yeer in this wise his lif he ladde,	And three years in this manner he led his life,
That wood out of his wit he goth for wo?	That he goes mad, out of his wits because of woe?
As, whan a thyng is shapen, it shal be --	As, when a thing is pre-ordained, it must be --
The nyght was short and faste by the day	The night was short and very close to the day
Or wynnen Emelye unto his wyf.	Or win Emelye to be his wife.
The silver dropes hangynge on the leves.	The silver drops hanging on the leaves.
By aventure his wey he gan to holde	By chance he began to hold his way
Ther as by aventure this Palamoun	Where by chance this Palamon
That was so ny to herknen al his sawe,	Who was near enough to hear all his speech,
Right so kan geery Venus overcaste	Just so can fickle Venus sadden
The blood roial of Cadme and Amphioun --	The royal blood of Cadmus and Amphion --
For I dar noght biknowe myn owene name;	For I dare not acknowledge my own name;
That shapen was my deeth erst than my sherte.	That my death was destined before my first garment was made.
For ire he quook; no lenger wolde he byde.	For anger he trembled; no longer would he wait.
And falsly chaunged hast thy name thus!	And thus hast falsely changed thy name!
This Arcite, with ful despitous herte,	This Arcite, with full spiteful heart,
What! Verray fool, thynk wel that love is free,	Lo! True fool, think well that love is free,
Ynough for thee, and clothes for thy beddynge.	Enough for thee, and bed-clothes for thy bedding.
Wol noght, his thankes, have no felaweshipe.	Will not, willingly, have any partnership.
This Arcite and this Palamon ben met.	This Arcite and this Palamon are met.
Or he moot sleen me, if that me myshappe."	Or he must slay me, if I suffer misfortune."
In his fightyng were a wood leon,	In his fighting was a mad lion,
So strong it is that, though the world had sworn	So strong it is that, though the world had sworn
That in his bed ther daweth hym no day	That in his bed there dawns for him no day
And Emelye, clothed al in grene,	And Emelye, clothed all in green,
And whan this duc was come unto the launde,	And when this duke was come unto the glade,
And pulled out a swerd and cride, "Hoo!	And pulled out a sword and cried, "Stop!
We have the deeth disserved bothe two.	We have deserved the death, both of us two.
For which he hath deserved to be deed.	For which he has deserved to be dead.
I am thy mortal foo, and it am I	I am thy mortal foe, and it is I
It nedeth noght to pyne yow with the corde.	There is no deed to torture you with the cord.
And alle crieden, bothe lasse and moore,	And all cried, both low ranking and high,
Yet in his resoun he hem bothe excused,	Yet in his reason he excused them both,
To hem that been in repentaunce and drede,	To those who are in repentance and fear,
How myghty and how greet a lord is he!	How mighty and how great a lord is he!
And yet hath love, maugree hir eyen two,	And yet has Love, despite anything they could do,
But this is yet the beste game of alle,	But this is yet the best joke of all,
And woot hou soore it kan a man distreyne,	And know how sorely it can afflict a man,
And they hym sworen his axyng faire and weel,	And they fairly and well swore to him (to do) his request,
Atones, though ye fighten everemo,	At once, though you were to fight for evermore,
Withouten any repplicacioun --	Without any arguing --
That wheither of yow bothe that hath myght --	That whichever of you both who has the power --
That oon of yow ne shal be deed or taken.	(Save this:) that one of you must be dead or taken.
And thonked hym with al hir herte and myght,	And thanked him with all their heart and might,
I dar wel seyen in this world ther nas.	I dare well say there was not (another such) in this world.
Was noon in erthe, as in so litel space;	Was none in earth, (constructed) in so little time;
And on the gate westward, in memorie	And on the westward gate, in memory
The shap, the contenaunce, and the figures	The shape, the appearance, and the figures
Beautee and Youthe, Bauderie, Richesse,	Beauty and Youth, Mirth, Riches,
For soothly al the mount of Citheroun,	For truly all the mount of Cithaeron,
The riche Cresus, kaytyf in servage.	The riche Cresus, wretched in servitude.
Was naked, fletynge in the large see,	Was naked, floating in the large sea,
A bowe he bar and arwes brighte and kene.	He carried a bow and arrows bright and keen.
In which ther dwelleth neither man ne best,	In which there dwells neither man nor beast,
That it made al the gate for to rese.	That it made all the gate to shake.
Of Felonye, and al the compassyng;	Of Felony, and all the scheming;
His herte-blood hath bathed al his heer --	His heart-blood has bathed all his hair --
The toun destroyed, ther was no thyng laft.	The town destroyed, there was nothing left.
That forgeth sharpe swerdes on his styth.	Who forges sharp swords on his anvil.
So was it shewed in that portreiture,	So was it shown in that portraiture,
This god of armes was arrayed thus.	This god of arms was arrayed thus.
Ther saugh I how woful Calistopee,	There I saw how woeful Callisto,
For vengeaunce that he saugh Diane al naked;	For vengeance that he saw Diana all naked;
With smale houndes al aboute hir feet,	With small hounds all about her feet,
And seyde, "Help, for thou mayst best of alle!"	And said, "Help, for thou canst (do so) best of all!"
That everich sholde an hundred knyghtes brynge	When each one should bring a hundred knights
For every wight that lovede chivalrye	For every person that loved chivalry
It were a lusty sighte for to see.	It would be a pleasing sight to see.
Armed were they, as I have yow told,	They were armed, as I have told you,
His shuldres brode, his armes rounde and longe;	His shoulders broad, his arms round and long;
Upon his heed, set ful of stones brighte,	Upon his head, set full of bright stones,
The grete Emetreus, the kyng of Inde,	The great Emetreus, the king of India,
And that was yelow, and glytered as the sonne.	And that was yellow, and glittered like the sun.
A gerland, fressh and lusty for to sene.	A garland, fresh and pleasing to look upon.
Ful many a tame leon and leopart.	Full many a tame lion and leopard.
Of noon estaat ne koude amenden it.	Of any rank could do better.
Of al this make I now no mencioun,	I now make no mention of all this,
I mene Venus, honurable and digne.	I mean Venus, honorable and worshipful.
And taak myn humble preyere at thyn herte.	And take my humble prayer to thy heart.
And holden werre alwey with chastitee.	And make war always against chastity.
To have victorie of hem, or they of me,	To have victory over them, or they over me,
That Arcita me thurgh the herte bere.	That Arcite stab me through the heart.
And made a signe, wherby that he took	And made a sign, whereby he understood
Ful redily with hem the fyr they hadde,	They had the fire full readily with them,
And yet it were a game to heeren al.	And yet it would be a pleasure to hear all.
Unto Dyane she spak as ye may heere:	Unto Diana she spoke as you may hear:
Ne nevere wol I be no love ne wyf.	Nor never will I be no lover nor wife.
This grace I preye thee withoute moore,	This grace I pray thee and ask no more,
Bihoold, goddesse of clene chastitee,	Behold, goddess of clean chastity,
That oother fyr was queynt and al agon;	That other fire was quenched and all gone;
And therwithal Dyane gan appeere,	And right then Diana did appear,
Shulle thee declaren, er that thou go henne,	Shall declare to thee, before thou go hence,
This is th'effect; ther is namoore to seye.	This is the substance; there is no more to say.
Of armes al the brydel in thyn hond,	All the control of arms in thy hand,
Of faire, yonge, fresshe Venus free,	Of fair, young, fresh Venus the noble,
For she that dooth me al this wo endure	For she that causes me to endure all this woe
Myn be the travaille, and thyn be the glorie!	Mine be the labor, and thine be the glory!
That nevere yet ne felte offensioun	That never yet felt injury
That it gan al the temple for to lighte;	That it began to illuminate all the temple;
Arcite anon unto his in is fare,	Arcite at once is gone unto his lodging,
That he ful soone hath plesed every part.	That he full soon has pleased every side.
Myn is the drenchyng in the see so wan;	Mine is the drowning in the sea so dark;
I slow Sampsoun, shakynge the piler;	I slew Sampson, shaking the pillar;
That causeth al day swich divisioun.	Which daily causes such dissension.
That al that Monday justen they and daunce,	That all that Monday they joust and dance,
Ther maystow seen devisynge of harneys	There canst thou see preparation of armor
The fomy steedes on the golden brydel	The steeds frothing on the golden bridles
Somme seyden thus, somme seyde "it shal be so";	Some said thus, some said "it shall be so";
Til that the Thebane knyghtes, bothe yliche	Until the Theban knights, both equally
Tho shewed he the myghty dukes wille:	Then showed he the mighty duke's will:
Ne short swerd, for to stoke with poynt bitynge,	Nor short sword, to stab with piercing point,
On outher syde, or elles sleen his make,	On either side, or else should slay his opponent,
And to the lystes rit the compaignye,	And to the lists rides the company,
It nas nat of the day yet fully pryme	It was not yet fully prime (nine a.m.) of the day
With baner whyt and hardy chiere and face.	With white banner and hardy countenance and face.
That in hir nombre gyle were ther noon,	So that in their total number there would be no deception,
He feeleth thurgh the herte-spoon the prikke.	He feels the stabbing through the breast-bone.
And he hym hurtleth with his hors adoun;	And he hurtles him down with his horse;
Ther nas no tygre in the vale of Galgopheye,	There was not any tiger in the vale of Gargaphia,
Som tyme an ende ther is of every dede.	Some time there is an end of every deed.
Is born out of his sadel a swerdes lengthe,	Is carried out of his saddle a sword's length,
He cryde, "Hoo! namoore, for it is doon!	He cried, "Stop! no more, for it is done!
Til that hir teeres in the lystes fille?	Until her tears fell in the lists?
This fierse Arcite hath of his helm ydon,	This fierce Arcite has taken off his helm,
For which his hors for fere gan to turne,	For which his horse for fear began to turn,
Tho was he korven out of his harneys	Then was he cut out of his armor
He shal been heeled of his maladye.	He shall be healed of his injuries.
Conforteth and honoureth every man,	Comforts and honors every man,
And haryed forth by arme, foot, and too,	And dragged forth by arm, foot, and toe,
And fully heeld a feeste dayes three,	And held a feast for fully three days,
Corrupteth, and is in his bouk ylaft,	Corrupts, and is left in the trunk of his body,
Vomyt upward, ne dounward laxatif.	Vomit upward, nor downward laxative.
Declare o point of alle my sorwes smerte	Declare one small part of all my painful sorrows
Myn hertes lady, endere of my lyf!	My heart's lady, ender of my life!
And Juppiter so wys my soule gye,	And as Jupiter may guide my soul,
And if that evere ye shul ben a wyf,	And if ever you shall be a wife,
Dusked his eyen two, and failled breeth,	His two eyes grew dark, and his breath failed,
Now wol I speken forth of Emelye.	Now will I speak forth of Emelye.
That at the laste certeinly they dye.	That at the last certainly they die.
"And haddest gold ynough, and Emelye?"	"Since thou haddest gold enough, and Emelye?"
"In al this world, that som tyme he ne deyde.	"In all this world, who some time did not die.
And eek moost honurable in his degree.	And also most honorable in (regard to) his rank.
The okes olde, and leye hem on a rewe	The old oaks, and lay them in a row
And in his hond a swerd ful bright and kene.	And in his hand a sword full bright and keen.
The rewefulleste of al the compaignye.	The most pitiful of all the company.
(Of brend gold was the caas and eek the harneys);	(Of pure gold was the quiver and also the fittings);
And on that oother syde duc Theseus,	And on that other side duke Theseus,
And twenty fadme of brede the armes straughte --	And twenty fathom of breadth the sides stretched --
Disherited of hire habitacioun,	Disinherited of their habitation,
And thanne with clooth of gold and with perrye,	And then with cloth of gold and with precious stones
Whan that the fyr was greet and brente faste;	When the fire was great and burned fast;
And how that lad was homward Emelye;	And how Emelye was led homeward;
And maken of my longe tale an ende.	And make an end of my long tale.
Leet senden after gentil Palamon,	Ordered (someone) to send for gentle Palamon,
And after that right thus he seyde his wille:	And after that exactly thus he pronounced his decision:
Certeyne dayes and duracioun	Specific (numbers of) days and (term of) duration
That every part dirryveth from his hool,	That every part derives from its whole,
This maystow understonde and seen at ye.	This thou canst understand and plainly see.
Thanne may ye se that al this thyng hath ende.	Then you can see that all things have an end.
That is prince and cause of alle thyng,	Who is prince and cause of all things,
And rebel is to hym that al may gye.	And is rebel to Him that can rule all.
To dyen whan that he is best of name.	To die when he has the most fame.
And yet they mowe hir lustes nat amende.	And as yet they may not change their desires.
With al th'avys heere of my parlement,	With all the advice of my parliament here,
Syn he hath served yow so many a yeer,	Since he has served you so many a year,
By al the conseil and the baronage.	By all the council and the baronage.
Of jalousie or any oother teene.	Of jealousy or any other vexation.
For she nys no thyng of swich pacience	For she is in no way of such patience
And crieth, `False coward, wrek thy wyf!	And cries, `False coward, avenge thy wife!
Or elles I am but lost, but if that I	Or else I am as good as lost, unless I
For ye shul telle a tale trewely.	For you must tell a tale truly.
Upon my feith, thou art som officer,	Upon my faith, thou art some officer,
Thou woldest han been a tredefowel aright.	Thou wouldest have been a chicken-copulator indeed,
Of tredyng, and we borel men been shrympes.	At copulating, and we laymen are shrimps.
This worthy Monk took al in pacience,	This worthy Monk took all in patience,
Of hym that stood in greet prosperitee,	Of one who stood in great prosperity,
Though I by ordre telle nat thise thynges,	Though I do not tell these things in chronological order,
To brynge hem out of hir adversitee.	To bring them out of their adversity.
O Lucifer, brightest of angels alle,	O Lucifer, brightest of all angels,
To labour, and to helle, and to meschaunce.	To labor, and to hell, and to ruin.
Withouten wepen save his handes tweye,	Without any weapon save his two hands,
For he on every tayl had knyt a brond;	For he on every tail had tied a torch;
Out of a wang-tooth sprang anon a welle,	Out of a molar sprang right away a well,
In al this world ne hadde been thy peere!	In all this world there had not been thy peer!
That in his heeris al his strengthe lay,	That all his strength lay in his hair,
Where-as they made hym at the queerne grynde.	Where they made him grind at the mill.
For he two pilers shook and made hem falle,	For he shook two pillars and made them fall,
If that it touche hir lymes or hir lyves.	If it concerns their limbs or their lives.
He slew the cruel tyrant Busirus	And made his hors to frete hym, flessh and boon;
Throughout this wide world his name ran,	What for his strengthe and for his heigh bountee,
Alas, this shirt -- alas and woe oh woe! --	Envenymed was so subtilly withalle
He has himself covered over in hot coals,	For with no venym deigned hym to dye.
Nebuchadnessar	The myghty trone, the precious tresor,
Of Israel he had gelded indeed,	And maked ech of hem to been his thral.
Commanded he to bow down, and hold in veneration,	Or in a fourneys, ful of flambes rede,
And ate hay like an ox, and lay outside	In reyn; with wilde beestes walked hee
He knew that God was full of might and grace.	Balthasar
A feast he made for all his lords	Upon a tyme and bad hem blithe bee;
Various wines out of these noble vessels.	And on a wal this kyng his eyen caste
Glory and honor, reign, treasure, income;	And he was proud and nothyng God ne dradde,
And then had God on him compassion,	And hym restored his regne and his figure.
"This hand was sent from God that on the wall	Wroot Mane, techel, phares, truste me;
For when Fortune will forsake a man,	She bereth awey his regne and his richesse,
That no person passed her in boldness,	Ne in lynage, ne in oother gentillesse.
And when she was older, she would kill	Leouns, leopardes, and beres al torente,
She disdained to be bound to no man.	But atte laste hir freendes han hire maried
In any way, that he should by her lie	But ones, for it was hir pleyn entente
Then would she once allow him to do the same.	Al were this Odenake wilde or tame,
So assiduous in the war, and courtly also,	Ne moore labour myghte in werre endure,
How she in virtue might spend her life.	And shortly of this storie for to trete,
Against Shapur the king and many others,	And how that al this proces fil in dede,
That there was no king nor prince in all that land	That he nas glad, if he that grace fond,
Within the field that dared fight with her,	Lest that she wolde hem with hir handes slen,
To wretchedness and to misfortune.	Aurelian, whan that the governaunce
Her chariot, that was wrought with gold and precious stones,	This grete Romayn, this Aurelian,
And she who wore helmets in violent battles	And wan by force townes stronge and toures,
And after, at a siege, by trickery,	Thou were bitraysed and lad unto his tente,
Ganelon-Oliver, corrupt for a bribe,	Broghte this worthy kyng in swich a brike.
And out of joy bring men to sorrow.	De Barnabo de Lumbardia
[Concerning Ugolino, Earl of Pisa]	Off the Erl Hugelyn of Pyze the langour
For Roger, who was bishop of Pisa,	Hadde on hym maad a fals suggestioun,
He heard it well, but he spoke absolutely nothing,	And in his herte anon ther fil a thoght
Now would God that I might sleep forever!	Thanne sholde nat hunger in my wombe crepe;
I can blame thy false wheel for all my woe."	His children wende that it for hunger was
Thus ended is this mighty Earl of Pisa.	From heigh estaat Fortune awey hym carf.
This wyde world hadde in subjeccioun,	Had this wide world in subjection,
To fisshe in Tybre, whan hym liste pleye.	To fish in Tiber, when he wished to amuse himself.
That he so litel of his mooder tolde!	That he reckoned so little of his mother!
To teche hym letterure and curteisye,	To teach him literature and courtesy,
Discreetly, as by word and nat by dede --	Discreetly, as by word and not by deed --
Chees in a bath to dye in this manere	Chose in a bath to die in this manner
Whan he leest weneth, sonnest shal he falle."	When he least expects it, the most quickly shall he fall."
That with his erys herde he how they seyde,	That with his ears he heard how they said,
To sleen hym and to girden of his heed,	To slay him and to strike off his head,
Ne moore pompous in heigh presumpcioun	Nor more arrogant in high presumption
Save in Bethulia, a strong citee,	Save in Bethulia, a strong city,
De Rege Antiocho illustri	[Concerning the Famous King Antiochus]
That verraily he wende he myghte attayne	That truly he supposed he might attain
That he bad greithen his chaar ful hastily,	That he ordered his chariot prepared very hastily,
For many a mannes guttes dide he peyne.	For many a man's gut did he pain.
Al forbrused, bothe bak and syde.	All badly bruised, both back and side.
Ful wlatsom was the stynk of his careyne;	Full loathsome was the stink of his decaying body;
Hath herd somwhat or al of his fortune.	Has heard something or all of his fortune.
Fortune hym made the heir of hire honour.	Fortune made him the heir of her honor.
For though I write or tolde yow everemo	For though I should write or told you evermore
Who shal me yeven teeris to compleyne	Who shall give me tears to complain
From humble bed to roial magestee	From humble bed to royal majesty
As fer as that the day bigynneth dawe,	As far as where the day begins to dawn,
Of Julius, and hym the heed he broghte.	Of Julius, and he brought him the head.
With boydekyns, as I shal yow devyse.	With daggers, as I shall tell you.
And so wel lovede estaatly honestee,	And so well loved dignified decency,
How that to thise grete conqueroures two	How to these two great conquerors
But swich a reyn doun fro the welkne shadde	But such a rain down from the sky poured
Of which he was so proud and eek so fayn	Of which he was so proud and also so pleased
"The tree," quod she, "the galwes is to meene,	"The tree," said she, "is to signify the gallows,
Tragedies noon oother maner thyng	Tragedies no other sort of thing
And worthy for to drawen to memorie,	And worthy to draw into memory,
He nolde avalen neither hood ne hat,	He would not doff neither hood nor hat,
"By Goddes soule," quod he, "that wol nat I;	"By God's soul," said he, "that will not I;
Bothe of a carpenter and of his wyf,	Both of a carpenter and of his wife,
Who hath no wyf, he is no cokewold.	He who has no wife, he is no cuckold.
I wol bileve wel that I am noon.	I will believe well that I am not one.
For Goddes love, demeth nat that I seye	For God's love, think not that I speak
The Millere is a cherl; ye knowe wel this.	The Miller is a churl; you know this well.
Hadde lerned art, but al his fantasye	Who had learned the arts curriculum, but all his desire
And therto he was sleigh and ful privee,	And moreover he was sly and very discreet,
On shelves couched at his beddes heed;	Arranged on shelves at his bed's head;
This carpenter hadde wedded newe a wyf,	This carpenter had recently wedded a wife,
But sith that he was fallen in the snare,	But since he was fallen in the snare,
The tapes of hir white voluper	The ribbons of her white cap
Tasseled with silk and perled with latoun.	Tasseled with silk and ornamented with latten "pearls."
Hir mouth was sweete as bragot or the meeth,	Her mouth was sweet as ale and honey or mead,
Now, sire, and eft, sire, so bifel the cas	Now, sir, and again, sir, it so happened
Or I wol dyen, also God me save!"	Or I will die, so save me God!"
And swoor hir ooth, by Seint Thomas of Kent,	And swore her oath, by Saint Thomas of Kent,
And thus they been accorded and ysworn	And thus they are agreed and sworn
So was it wasshen whan she leet hir werk.	It was so washed when she left her work.
Al in a kirtel of a lyght waget;	All in a tunic of a light blue;
And pleyen songes on a smal rubible;	And play songs on a small fiddle,
Sensynge the wyves of the parisshe faste;	Censing the wives of the parish eagerly;
For curteisie, he seyde, he wolde noon.	For courtesy, he said, he would have none.
"Now, deere lady, if thy wille be,	"Now, dear lady, if it be thy will,
Fro day to day this joly Absolon	From day to day this elegant Absolon
For som folk wol ben wonnen for richesse,	For some folk will be won for riches,
Ful sooth is this proverbe, it is no lye,	Very true is this proverb, it is no lie,
And hende Nicholas and Alisoun	And clever Nicholas and Alisoun
Bothe mete and drynke for a day or tweye,	Both food and drink for a day or two,
And eet and sleep, or dide what hym leste,	And ate and slept, or did what he pleased,
"Go up," quod he unto his knave anoon,	"Go up," he said unto his servant at once,
Ther as the cat was wont in for to crepe,	Where the cat was accustomed to creep in,
This man is falle, with his astromye,	This man is fallen, because of his astronomy,
He saugh nat that. But yet, by Seint Thomas,	He did not see that. But yet, by Saint Thomas,
Into the floor the dore fil anon.	Onto the floor the door fell straightway.
On foure halves of the hous aboute,	On four corners of the house about,
What! Thynk on God, as we doon, men that swynke."	What! Think on God, as we do, men who work."
He seyde, "John, myn hooste, lief and deere,	He said, "John, my host, beloved and dear,
Sey what thou wolt, I shal it nevere telle	Say what thou will, I shall never tell it
Thus shal mankynde drenche, and lese hir lyf."	Thus shall mankind drown, and lose their lives."
And if thou werken wolt by good conseil,	And if thou will act in accordance with good advice,
Hym hadde be levere, I dar wel undertake,	He would rather, I dare well guarantee,
And han therinne vitaille suffisant	And have therein sufficient victuals
Thy wyf shal I wel saven, out of doute.	Thy wife shall I well save, beyond doubt.
And breke an hole an heigh, upon the gable,	And break a hole on high, upon the gable,
And thanne shul we be lordes al oure lyf	And then shall we be lords all our life
Namoore in lookyng than ther shal in deede.	No more in looking than there shall be in deed.
This sely carpenter goth forth his wey.	This hapless carpenter goes forth his way.
Lo, which a greet thyng is affeccioun!	Lo, what a great thing is emotion!
And after that a tubbe and a kymelyn,	And after that a tub and a large vat,
He sente his knave, and eek his wenche also,	He sent his servant, and also his servant girl,
And stille he sit, and biddeth his preyere,	And still he sits, and says his prayer,
Ther as the carpenter is wont to lye.	Where the carpenter is accustomed to lie.
And axed upon cas a cloisterer	And by chance asked a cloistered monk
This Absolon ful joly was and light,	This Absolon very was jolly and happy,
Som maner confort shal I have, parfay.	Some sort of comfort shall I have, by my faith.
To smellen sweete, er he hadde kembd his heer.	To smell sweet, ere he had combed his hair.
Wel litel thynken ye upon my wo,	Well little you think upon my woe,
Wel bet than thee, by Jhesu, Absolon.	Well better than thee, by Jesus, Absolon.
And unto Nicholas she seyde stille,	And unto Nicholas she said quietly,
Derk was the nyght as pich, or as the cole,	Dark was the night as pitch, or as the coal,
And Absolon gooth forth a sory pas.	And Absolon goes forth walking sadly.
But me were levere than al this toun," quod he,	If I would not rather than (have) all this town," said he,
Until a smyth men cleped daun Gerveys,	To a smith men called dan Gerveys,
By Seinte Note, ye woot wel what I mene."	By Saint Note, you know well what I mean."
Thou sholdest have, as I am trewe smyth.	Thou sholdest have it, as I am true smith.
That knokketh so? I warante it a theef."	That knocks so? I swear it is a thief."
And up the wyndowe dide he hastily,	And he opened up the window hastily,
Of gooth the skyn an hande-brede aboute,	Off goes the skin a hand's breadth about,
And doun gooth al; he foond neither to selle,	And down goes all; he found nothing to sell (wasted no time),
For whan he spak, he was anon bore doun	For when he spoke, he was immediately put down
Into the roof they kiken and they cape,	Into the roof they stare and they gape,
For al his kepyng and his jalousye,	In spite of all his guarding and his jealousy,
The monk putte in the mannes hood an ape,	The monk made a monkey of the man,
A tale next, if so were that ye wolde.	A tale next, if it so were that you would.
My shadwe was at thilke tyme, as there	My shadow was there at that same time,
Fulfilled is my sentence and my decree;	Fulfilled is my plan and my decree;
For trewely, me thynketh by thy cheere	For truly, it seems to me from your appearance
For which I seye, if that yow list to heere	For which I say, if you want to hear
To knytte up al this feeste and make an ende.	To conclude all this festivity and make an end.
Of clerkes, for I am nat textueel;	By clerks, for I am not learned in texts;
Oure Hoost hadde the wordes for us alle;	Our Host had the words for us all;
Oure Hooste gan to swere as he were wood;	Our Host began to swear as if he was crazy;
Hire beautee was hire deth, I dar wel sayn.	Her beauty was her death, I dare well say.
And every boyste ful of thy letuarie;	And every container full of thy electuaries;
Myn herte is lost for pitee of this mayde.	My heart is lost for pity of this maid.
"I graunte, ywis," quod he, "but I moot thynke	"I agree, indeed," said he, "but I must think
And thanne my bulles shewe I, alle and some.	And then my papal bulls I show, each and every one.
And for to stire hem to devocioun.	And to stir them to devotion.
Taak water of that welle and wassh his tonge,	Take water of that well and wash its tongue,
`And, sires, also it heeleth jalousie;	`And, sirs, it also heals jealousy;
So that he offre pens, or elles grotes.	Providing that he offer pennies, or else fourpences.
He wol come up and offre a Goddes name,	He will come up and offer in God's name,
And est and west upon the peple I bekke,	And east and west upon the people I nod,
Though that hir soules goon a-blakeberyed!	Though their souls go picking blackberries!
Hath trespased to my bretheren or to me.	Has trespassed to my brethren or to me.
Radix malorum est Cupiditas.	`Greed is the root of all evil.'
Of olde stories longe tyme agoon.	Of old stories from long time ago.
By cause I wol nat beggen ydelly.	Because I will not beg idly.
Now have I dronke a draughte of corny ale,	Now I have drunk a draft of strong ale,
As riot, hasard, stywes, and tavernes,	Such as debauchery, gambling, brothels, and taverns,
Hem thoughte that Jewes rente hym noght ynough --	They thought that the Jews did not tear him enough --
Lo, how that dronken Looth, unkyndely,	Lo, how that drunken Lot, unnaturally,
And a man which that is dronkelewe,	And a man that is drunk,
Adam oure fader, and his wyf also,	Adam our fader, and his wife also,
He wolde been the moore mesurable	He would be the more moderate
To seye this word, and fouler is the dede,	To say this word, and fouler is the deed,
Fulfilled of dong and of corrupcioun!	Filled with dung and with corruption!
Shal been his sauce ymaked by delit,	Shall his sauce be made for delight,
And yet, God woot, Sampsoun drank nevere no wyn.	And yet, God knows, Sampson never drank any wine.
This wyn of Spaigne crepeth subtilly	This wine of Spain creeps subtly
Of victories in the Olde Testament,	Of victories in the Old Testament,
Nat Samuel, but Lamuel, seye I;	Not Samuel, but Lamuel, I say;
It is repreeve and contrarie of honour	It is a disgrace and contrary to honor
Fro Lacidomye to make hire alliaunce.	From Sparta to make their alliance.
For, by my trouthe, me were levere dye	For, by my troth, I would rather die
For which he heeld his glorie or his renoun	For which he held his glory or his renown
Of sweryng seith the hooly Jeremye,	Of swearing says the holy Jeremiah,
I seye that, as by ordre, thus it stondeth;	I say that, so far as order is concerned, thus it stands;
This daggere shal thurghout thyn herte go!" --	This dagger shall go throughout thy heart!" --
Biforn a cors, was caried to his grave.	Before a corpse, which was carried to its grave.
Ther cam a privee theef men clepeth Deeth,	There came a stealthy thief men call Death,
"By Seinte Marie!" seyde this taverner,	"By Saint Mary!" said this tavern-keeper,
I make avow to Goddes digne bones!	I make a vow to God's honorable bones!
And up they stirte, al dronken in this rage,	And up they leaped, all drunken in this rage,
And seyde thus, "Now, lordes, God yow see!"	And said thus, "Now, lords, may God look after you!"
And therfore moot I han myn age stille,	And therefore I must have my age still,
That in my chambre longe tyme hath be,	That in my chamber long time has been,
Ne dooth unto an oold man noon harm now,	Do no harm now unto an old man,
Have heer my trouthe, as thou art his espye,	Have here my pledge, as thou art his spy,
Se ye that ook? Right there ye shal hym fynde.	Do you see that oak? Right there you shall find him.
That doun they sette hem by this precious hoord.	That they set themselves down by this precious hoard.
Hoom to myn hous, or elles unto youres --	Home to my house, or else unto yours --
And he that hath the cut with herte blithe	And he who has the shortest straw with happy heart
And forth toward the toun he wente anon.	And forth toward the town he went right away.
Hadde I nat doon a freendes torn to thee?"	Had I not done a good turn to thee?"
And two of us shul strenger be than oon.	And two of us shall be stronger than one.
And thus acorded been thise shrewes tweye	And thus these two scoundrels are agreed
Putte in his thought that he sholde poyson beye,	Put in his thought that he should buy poison,
And eek ther was a polcat in his hawe,	And also there was a polecat in his yard,
Ye, sterve he shal, and that in lasse while	Yea, he shall die, and that in less time
In cariynge of the gold out of that place.	In carrying of the gold out of that place.
And with that word it happed hym, par cas,	And with that word it happened to him, by chance,
O cursed synne of alle cursednesse!	O cursed sin of all cursedness!
And ware yow fro the synne of avarice!	And guard yourselves from the sin of avarice!
As ye were born. -- And lo, sires, thus I preche.	As you were born. -- And lo, sirs, thus I preach.
Com forth anon, and kneleth heere adoun,	Come forth straightway, and kneel down here,
Paraventure ther may fallen oon or two	Perhaps there may fall one or two
Ye, for a grote! Unbokele anon thy purs."	Yea, for a fourpence coin! Unbuckle thy purse right now."
They shul be shryned in an hogges toord!"	They shall be enshrined in a hog's turd!"
I prey yow that ye kisse the Pardoner.	I pray you that you kiss the Pardoner.
Lest that the feend thurgh ydelnesse us hente.	Lest the fiend by means of idleness seize us.
That ydelnesse is roten slogardye,	That idleness is rotten laziness,
Thou with thy gerland wroght with rose and lilie --	Thou with thy garland made with rose and lily --
Thow welle of mercy, synful soules cure,	Thou well of mercy, sinful souls' cure,
Ay heryen; and thou, Virgine wemmelees,	Ever praise; and thou, Virgin without blemish,
Now help, thow meeke and blisful faire mayde,	Now, thou meek and blissful fair maid help
O thou, that art so fair and ful of grace,	O thou, that art so fair and full of grace,
Now help, for to my werk I wol me dresse.	Now help, for to my work I will address myself.
It is to seye in Englissh "hevenes lilie,"	It is to say in English "heaven's lily,"
The "hevene" is set for thoght of hoolynesse,	The "heaven" is set for her holiness of thought,
And right as men may in the hevene see	And just as men may in the heaven see
And round and hool in good perseverynge,	And round and whole in persevering in good (works),
And whan this mayden sholde unto a man	And when this maiden should unto a man
Unwemmed, lest that I confounded be."	Immaculate, lest that I be damned."
So that ye swere ye shul it nat biwreye."	Providing that you swear you shall not reveal it."
He right anon wol sle yow with the dede,	He straightway will slay you in the act,
And if thou love another man, for sothe	And if thou love another man, in truth
To shewen yow the goode Urban the olde,	To show you the good Urban the old,
And he anon withouten tariynge	And he immediately without delay
"For thilke spouse that she took but now	"For that same spouse that she took just now
"O Lord, o feith, o God, withouten mo,	"One Lord, one faith, one God, without more,
And Pope Urban hym cristned right there.	And Pope Urban christened him right there.
"Fro paradys to yow have I hem broght,	"From paradise I have brought them to you,
I pray yow that my brother may han grace	I pray you that my brother may have grace
Whennes that soote savour cometh so	Whence that sweet fragrance comes so (much)
So shaltow seen hem, leeve brother deere,	So shalt thou see them, beloved brother dear,
"The aungel of God hath me the trouthe ytaught	"The angel of God has taught me the truth
Witnesse Tyburces and [Valerians] shrifte,	Witness Tyburce's and Valerian's confession,
And charged hym his ydoles for to leve.	And (she) ordered him to leave his idols.
Anon for myn allye heer take I thee,	Right now here I take thee for my kinsman,
Quod tho Tiburce, "woltow me thider lede?	Said then Tiburce, "wilt thou lead me there?
That is yhid in hevene pryvely,	That is hidden secretly in heaven,
And al that wroght is with a skilful thoght;	And all that is created (and endowed) with the power of reason;
"That shal I telle," quod she, "er I go.	"That shall I tell," said she, "ere I go.
That was ybounde in synne and cares colde;	Which was bound in sin and painful cares;
That he God axed, it was sped ful soone.	That he asked of God was provided immediately.
Anon thise martirs that I yow devyse,	Immediately these martyrs of whom I tell you,
And fro Maxime, and fro his folk echone,	And from Maxime, and from his folk each one of them,
Youre cours is doon, youre feith han ye conserved.	Your race is done, your faith you have maintained.
With humble herte and sad devocioun,	With humble heart and steadfast devotion,
Cecile hym took and buryed hym anon	Cecile took him and buried him straightway
"Crist, Goddes Sone, withouten difference,	"Christ, God's Son, without difference [between Father and Son],
Of thy religioun and of thy bileeve."	About thy religion and about thy belief."
"Youre myght," quod she, "ful litel is to dreede,	"Your might," said she, "is very little to fear,
But if that he his Cristendom withseye,	Unless he renounce his Christian faith,
For vertuous, we may it nat withseye."	To be so virtuous, we can not deny it."
He stareth, and woodeth in his advertence!"	He stares, and goes mad in his mind!"
"And if thou drede nat a sooth to heere,	"And if thou dread not to hear a truth,
"Do wey thy booldnesse," seyde Almachius tho,	"Do away thy boldness," said Almachius then,
A lewed officer and a veyn justise.	An ignorant officer and a foolish judge.
For communly men woot it wel overal	For without exception men know it well everywhere
For in a bath they gonne hire faste shetten,	For they did shut her fast in a cauldron,
The tormentour, but for no maner chaunce	The executioner, but in no sort of way
Thre dayes lyved she in this torment,	Three days she lived in this torment,
Seint Urban with his deknes prively	Saint Urban with his deacons secretly
That lyk an aspen leef he quook for ire.	That like an aspen leaf he quaked for ire.
In spirit ones by a visioun;	In spirit once by a vision;
`And now hath Sathanas,' seith he, `a tayl	`And now has Satan,' says he, `a tail
And comen agayn as faste as they may gon,	And came back again as fast as they can go,
God save yow alle, save this cursed Frere!	God save you all, except this cursed Friar!
Excited he the peple in his prechyng	Excited he the people in his preaching
Ye, whan that they been hastily ysonge,	Yes, when they are hastily sung,
He wente his wey; no lenger wolde he reste.	He went his way; no longer would he stay.
"Yif us a busshel whete, malt, or reye,	"Give us a bushel of wheat, malt, or rye,
And what men yaf hem, leyde it on his bak.	And what men gave them, laid it on his back.
Cam til an hous ther he was wont to be	Came to a house where he was accustomed to be
And leyde adoun his potente and his hat,	And laid down his walking stick and his hat,
Have I seyd many a precious orison,	Have I said many a precious prayer,
And spende hir good ther it is resonable;	And spend their goods where it is reasonable;
As he that is youre servant every deel,	As he who is your servant every bit,
Thise curatz been ful necligent and slowe	These curates are very negligent and slow
Though that he have al that he kan desire;	Though he have all that he can desire;
"Now, maister," quod the wyf, "er that I go,	"Now, master," said the wife, "before I go,
The body is ay so redy and penyble	The body is always so ready and accustomed
I dar wel seyn that, er that half an hour	I dare well say that, before half an hour
Te Deum was oure song, and nothyng elles,	Te Deum was our song, and nothing else,
We han this worldes lust al in despit.	We hold this world's lust all in scorn.
Fasted, er that the heighe God of myght	Fasted, before the high God of might
Into the temple whan they sholde gon	Into the temple when they should go
Therfore we mendynantz, we sely freres,	Therefore we mendicants, we innocent friars,
Was man out chaced for his glotonye;	Was man chased out for his gluttony;
Or hirs that swymmen in possessioun.	Or theirs who swim in possessions.
But we that humble been, and chaast, and poore,	But we who are humble, and chaste, and poor,
To Crist, that he thee sende heele and myght	To Christ, that he send thee health and strength
What nedeth hym that hath a parfit leche	Why does one who has a perfect physician need
Nay, nay, Thomas, it may no thyng be so!	Nay, nay, Thomas, it may in no way be so!
To preye for yow is ay so diligent,	To pray for you is always so diligent,
Ne stryve nat with thy wyf, as for thy beste;	Strive not with thy wife, for thine own good;
Be war, my sone, and herkne paciently	Beware, my son, and hearken patiently
Abhomynable unto the God of hevene;	Abominable unto the God of heaven;
To sette an irous man in heigh degree.	To set an angry man in high position.
`Go lede hym to the deeth, I charge thee.'	`Go lead him to the death, I charge thee.'
And to the firste knyght right thus spak he,	And to the first knight right thus spoke he,
That loved vertuous moralitee	Who loved virtuous morality
"`The revers shaltou se,' quod he, `anon,	"`The reverse shalt thou see,' said he, `right now,
And sodeynly he took his bowe in honde,	And suddenly he took his bow in hand,
But if it be unto a povre man.	Unless it be unto a poor man.
`Ne be no felawe to an irous man,	`Be no fellow to an angry man,
I have hym toold hoolly al myn estat;	I have him told completely all my condition;
By God, we owen fourty pound for stones.	By God, we owe forty pounds for stones.
"But syn Elye was, or Elise,	"But since Elijah was, or Elisha,
Ye sey me thus, how that I am youre brother?"	You say me thus, that I am your brother?"
Withouten fraude or cavillacioun."	Without fraud or quibbling."
In hope for to fynde there a yifte.	In hope to find there a gift.
His meynee, whiche that herden this affray,	His servants, who heard this affray,
This frere cam as he were in a rage,	This friar came as if he were in a rage,
"I have," quod he, "had a despit this day,	"I have," said he, "had an insult this day,
Thogh I have had in scole that honour.	Though I have had in school that honor.
Ye been the salt of the erthe and the savour.	You are the salt of the earth and the delight.
I seye a cherl hath doon a cherles dede.	I say a churl has done a churl's deed.
The lord sat stille as he were in a traunce,	The lord sat still as if he were in a trance,
As of the soun or savour of a fart?	As of the sound or odor of a fart?
Ther is no man kan deemen, by my fey,	There is no man can judge, by my faith,
"My lord," quod he, "be ye nat yvele apayd,	"My lord," said he, "if you be not displeased,
But looke that it have his spokes alle --	But see that it has all its spokes --
Shal holde his nose upright under the nave.	Shall hold his nose upright under the nave.
By cause he is a man of greet honour,	Because he is a man of greet honor,
He bereth hym so faire and hoolily."	He bears him so faire and holily."
Ther was, as telleth Titus Livius,	There was, as Titus Livius tells,
As though she wolde seyn, "Lo! I, Nature,	As though she would say, "Lo! I, Nature,
To forme and peynten erthely creaturis	To form and paint earthly creatures
In which that Nature hadde swich delit.	In whom Nature had such delight.
In hire ne lakked no condicioun	In her there lacked no characteristic
No countrefeted termes hadde she	No pretentious terms had she
And of hir owene vertu, unconstreyned,	And of her own moral strength, of her own free choice,
Of booldnesse, whan she woxen is a wyf.	Of boldness, when she is grown to be a wife.
For everemo; therfore, for Cristes sake,	For evermore; therefore, for Christ's sake,
Of alle tresons sovereyn pestilence	Of all betrayals the supreme wickedness
Under a shepherde softe and necligent	Under a soft and negligent shepherd
For which the fame out sprong on every syde,	For which sprang out all around the fame,
Now was ther thanne a justice in that toun,	Now was there then a justice in that town,
And taughte hym sodeynly that he by slyghte	And taught him suddenly that he by trickery
Which that he knew for subtil and for boold.	Whom he knew for trickery and for boldness.
Parfourned sholde been ful subtilly,	Should be accomplished very subtly,
This false juge, as telleth us the storie,	This false judge, as the story tells us,
The juge answerde, "Of this, in his absence,	The judge answered, "Of this, in his absence,
Agayns the lawe, agayn al equitee,	Against the law, against all equity,
Virginius gan upon the cherl biholde,	Virginius began to look upon the churl,
Go bryng hire forth, and put hire in oure warde.	Go bring her forth, and put her in our guardianship.
With fadres pitee stikynge thurgh his herte,	With a father's pity stabbing through his heart,
O doghter, which that art my laste wo,	O daughter, who art my greatest woe,
"O mercy, deere fader!" quod this mayde,	"O mercy, dear father!" said this maid,
For to compleyne, er he hir slow, allas!	To lament, before he slew her, alas!
And with that word she preyed hym ful ofte	And with that word she prayed him repeatedly
To save the knyght, for routhe and for pitee,	To save the knight, for compassion and for pity,
Was demed for to hange upon a tree,	Was condemned to hang upon a tree,
Of wikked lyf, though it so pryvee be	Because of a wicked life, though it so secret be
A wyf he hadde of excellent beautee;	He had a wife of excellent beauty;
Al for his owene worshipe richely,	Richly, all for the sake of his own reputation,
That wonder is; but herkneth to my tale.	That it is a wonder; but listen to my tale.
And for as muchel as this goode man,	And in view of the fact that this good man,
Free was daun John, and manly of dispence,	Free-handed was Don John, and generous in spending
But so bifel, this marchant on a day	But as it happened, this merchant on a day
Hath of his abbot, as hym list, licence,	Has of his abbot, as he pleases, permission,
And thus I lete hem ete and drynke and pleye,	And thus I let them eat and drink and amuse themselves,
He leith biforn hym on his countyng-bord.	He lays before him on his counting-board.
Into the gardyn, there he walketh softe,	Into the garden, where he walks quietly,
As been thise wedded men, that lye and dare	As are these wedded men, that lie and doze
And seyde thus, "Ye, God woot al," quod she.	And said thus, "Yea, God knows all," she said.
So ful am I of drede and eek of care."	I am so full of dread and also of care."
Ne shal I of no conseil yow biwreye."	Shall I betray any of your secrets."
"Cosyn," quod she, "if that I hadde a space,	"Cousin," she said, "if I had a space of time,
Of yow, which I have loved specially	With you, whom I have loved especially
Inspired hath in every holt and heeth	In every wood and field has breathed life into
Of Engelond to Caunterbury they wende,	Of England to Canterbury they travel,
In felaweshipe, and pilgrimes were they alle,	In fellowship, and they were all pilgrims,
Er that I ferther in this tale pace,	Before I proceed further in this tale,
Trouthe and honour, fredom and curteisie.	Fidelity and good reputation, generosity and courtesy.
In Gernade at the seege eek hadde he be	Also he had been in Grenada at the siege
Agayn another hethen in Turkye;	Against another heathen in Turkey;
Al bismotered with his habergeon,	All stained (with rust) by his coat of mail,
In Flaundres, in Artoys, and Pycardie,	In Flanders, in Artois, and Picardy,
Juste and eek daunce, and weel purtreye and write.	Joust and also dance, and well draw and write.
(Wel koude he dresse his takel yemanly;	(He well knew how to care for his equipment as a yeoman should;
An horn he bar, the bawdryk was of grene;	He carried a horn, the shoulder strap was green;
For Frenssh of Parys was to hire unknowe.	For French of Paris was to her unknown.
Ful semely after hir mete she raughte.	She reached for her food in a very seemly manner.
Of smale houndes hadde she that she fedde	She had some small hounds that she fed
For, hardily, she was nat undergrowe.	For, certainly, she was not undergrown.
An outridere, that lovede venerie,	An outrider (a monk with business outside the monastery), who loved hunting,
And heeld after the newe world the space.	And followed the broader customs of modern times.
Or swynken with his handes, and laboure,	Or work with his hands, and labor,
He hadde of gold ywroght a ful curious pyn;	He had a very skillfully made pin of gold;
A fat swan loved he best of any roost.	A fat swan loved he best of any roast.
With frankeleyns over al in his contree,	With landowners every where in his country,
Is signe that a man is wel yshryve;	Is a sign that a man is well confessed;
Wel koude he synge and pleyen on a rote;	He well knew how to sing and play on a rote (string instrument);
It is nat honest; it may nat avaunce,	It is not respectable; it can not be profitable,
So plesaunt was his "In principio,"	So pleasant was his "In the beginning,"
Somwhat he lipsed, for his wantownesse,	Somewhat he lisped, for his affectation,
His resons he spak ful solempnely,	His opinions he spoke very solemnly,
But, sooth to seyn, I noot how men hym calle.	But, to say the truth, I do not know what men call him.
Twenty bookes, clad in blak or reed,	Twenty books, bound in black or red,
Noght o word spak he moore than was neede,	He spoke not one word more than was needed,
Justice he was ful often in assise,	He was very often a judge in the court of assizes,
That from the tyme of kyng William were falle.	That from the time of king William have occurred.
Wel loved he by the morwe a sop in wyn;	He well loved a bit of bread dipped in wine in the morning;
Of fissh and flessh, and that so plentevous	Of fish and meat, and that so plentiful
Stood redy covered al the longe day.	Stood covered (with table cloth) and ready all the long day.
Of a solempne and a greet fraternitee.	Of a solemn and a great parish guild.
And eek hir wyves wolde it wel assente;	And also their wives would well assent to it;
Maken mortreux, and wel bake a pye.	Make stews, and well bake a pie.
The hoote somer hadde maad his hewe al broun;	The hot summer had made his hue all brown;
Ther nas noon swich from Hulle to Cartage.	There was none other such from Hull to Cartagena (Spain).
For he was grounded in astronomye.	For he was instructed in astronomy.
Anon he yaf the sike man his boote.	Straightway he gave the sick man his remedy.
Bernard, and Gatesden, and Gilbertyn.	Bernard, and Gaddesden, and Gilbertus.
Therefore he lovede gold in special.	Therefore he loved gold in particular.
I dorste swere they weyeden ten pound	I dare swear they weighed ten pound
She hadde passed many a straunge strem;	She had passed many a foreign sea;
In felaweshipe wel koude she laughe and carpe.	In fellowship she well knew how to laugh and chatter.
And in adversitee ful pacient,	And very patient in adversity,
The ferreste in his parisshe, muche and lite,	Those living farthest away in his parish, high-ranking and low,
A shiten shepherde and a clene sheep.	A shit-stained shepherd and a clean sheep.
He was a shepherde and noght a mercenarie.	He was a shepherd and not a hireling.
A bettre preest I trowe that nowher noon ys.	I believe that nowhere is there a better priest.
At alle tymes, thogh him gamed or smerte,	At all times, whether it pleased or pained him,
A MAUNCIPLE, and myself -- ther were namo.	A MANCIPLE, and myself -- there were no more.
Upon the cop right of his nose he hade	Upon the exact top of his nose he had
A whit cote and a blew hood wered he.	He wore a white coat and a blue hood.
That swich a lewed mannes wit shal pace	That such an unlearned man's wit shall surpass
And able for to helpen al a shire	And (they would be) able to help all a shire
Ther was noon auditour koude on him wynne.	There was no auditor who could earn anything (by catching him).
That he ne knew his sleighte and his covyne;	Whose trickery and treachery he did not know;
He was a wel good wrighte, a carpenter.	He was a very good craftsman, a carpenter.
That hadde a fyr-reed cherubynnes face,	Who had a fire-red cherubim's face,
Wel loved he garleek, oynons, and eek lekes,	He well loved garlic, onions, and also leeks,
But whoso koude in oother thyng hym grope,	But whoever knew how to examine him in other matters,
He wolde techen him to have noon awe	He would teach him to have no awe
The yonge girles of the diocise,	The young people of the diocese,
Was nevere trompe of half so greet a soun.	There was never a trumpet of half so great a sound.
Swiche glarynge eyen hadde he as an hare.	He had glaring eyes such as has a hare.
For in his male he hadde a pilwe-beer,	For in his pouch he had a pillow-case,
Than that the person gat in monthes tweye;	Than the parson got in two months;
Therefore he song the murierly and loude.	Therefore he sang the more merrily and loud.
And al the remenaunt of oure pilgrimage.	And all the rest of our pilgrimage.
Al speke he never so rudeliche and large,	Although he may speak ever so rudely and freely,
Al have I nat set folk in hir degree	Although I have not set folk in order of their rank
A fairer burgeys was ther noon in Chepe --	There was no better business man in Cheapside --
I saugh nat this yeer so myrie a compaignye	I saw not this year so merry a company
To ride by the weye doumb as a stoon;	To ride by the way dumb as a stone;
Oure conseil was nat longe for to seche.	Our decision was not long to seek out.
And homward he shal tellen othere two,	And on the homeward trip he shall tell two others,
Right at myn owene cost, and be youre gyde;	Entirely at my own cost, and be your guide;
And of oure tales juge and reportour,	And judge and score keeper of our tales,
And gadrede us togidre alle in a flok,	And gathered us together all in a flock,
Shal paye for al that by the wey is spent.	Shall pay for all that is spent by the way.
Were it by aventure, or sort, or cas,	Were it by chance, or destiny, or luck,
What, welcome be the cut, a Goddes name!	What! Welcome be the draw, in God's name!
Ne at this tale I saugh no man hym greve,	And at this tale I saw no man aggrieved,
This white top writeth myne olde yeris;	This white head reveals my old years;
As hath a leek; for thogh oure myght be goon,	As a leek has; for though our power is gone,
As many a yeer as it is passed henne	As many years as have passed hence
Whan that oure Hoost hadde herd this sermonyng,	When our Host had heard this sermon making,
"Now, sires," quod this Osewold the Reve,	"Now, sires," said this Osewold the Reeve,
He kan wel in myn eye seen a stalke,	He can well in my eye see a piece of straw,
And turne coppes, and wel wrastle and sheete;	And play a drinking game, and well wrestle and shoot;
That he ne swoor he sholde anon abegge.	That he did not swear he should pay for it right away.
But she were wel ynorissed and a mayde,	Unless she were well educated and a virgin,
That with hire dorste rage or ones pleye,	That dared flirt with her or once play,
That she hadde lerned in the nonnerie.	Which she had learned in the nunnery.
In purpos was to maken hire his heir,	Was determined to make her his heir,
With whete and malt of al the land aboute;	With wheat and malt of all the land about;
But now he was a theef outrageously,	But now he was a thief excessively,
To goon to mille and seen hir corn ygrounde;	To go to the mill and see their grain ground;
Forth goth Aleyn the clerk, and also John,	Forth goes Aleyn the clerk, and also John,
Or elles he is a fool, as clerkes sayn.	Or else he is a fool, as clerks say.
Yet saugh I nevere, by my fader kyn,	Yet saw I never, by my father's kin,
They wene that no man may hem bigyle,	They think that no man can trick them,
Whan that he saugh his tyme, softely.	When he saw his time, quietly.
But dooth his note, and with the clerkes pleyde	But does his work, and with the clerks amused himself
"What, whilk way is he geen?" he gan to crie.	"What, which way is he gone?" he began to cry.
Why ne had thow pit the capul in the lathe?	Why did thou not put the horse in the barn?
Lo, wher he gooth! Ye, lat the children pleye.	Lo, there he goes! Yes, let the children play.
Comth sely John, and with him comth Aleyn.	Comes hapless John, and with him comes Aleyn.
But for the love of God they hym bisoght	But for the love of God they ask him
Ay is thou myrie, and this is faire answerd.	Thou art always joking, and this is nicely answered.
And boond hire hors, it sholde namoore go loos,	And tied up their horse, it should no more go loose,
Aboute mydnyght wente they to reste.	About midnight they went to bed.
And whan that dronken al was in the crowke,	And when all that was in the crock was drunk,
Aleyn the clerk, that herde this melodye,	Aleyn the clerk, who heard this melody,
If that I may, yon wenche wil I swyve.	If I can, yon wench will I screw.
This John answerde, "Alayn, avyse thee!	This John answered, "Alayn, be careful!
Now pley, Aleyn, for I wol speke of John.	Now play, Aleyn, for I will speak of John.
I sal been halde a daf, a cokenay!	I shall be considered a fool, a weakling!
"Allas!" quod she, "I hadde almoost mysgoon;	"Alas!" said she, "I had almost gone wrong;
Withinne a while this John the clerk up leep,	Within a moment this John the clerk leaped up,
But everemo, wher so I go or ryde,	But evermore, wherever I walk or ride,
And with that word almoost she gan to wepe.	And with that word she almost began to weep.
Unto the bed ther as the millere lay.	Unto the bed where the miller lay.
"Ye, false harlot," quod the millere, "hast?	"Yes, false scoundrel," said the miller, "hast (thou done so)?
They walwe as doon two pigges in a poke;	They wallow as do two pigs in a bag;
Awak, Symond! The feend is on me falle.	Awake, Symond! The fiend has fallen on me.
For at an hole in shoon the moone bright,	For at a hole in shone the moon bright,
Thise clerkes beete hym weel and lete hym lye,	These clerks beat him well and let him lie,
Lo, swich it is a millere to be fals!	Lo, this is how it is when a miller is false!
Til that oure Hooste japen tho bigan,	Until our Host then began to joke
He semeth elvyssh by his contenaunce,	He seems otherworldly in his behavior,
Listeth, lordes, in good entent,	Listen, my lords, with good will,
And lord he was of that contree,	And he was lord of that country,
His shoon of cordewane.	His shoes of Cordovan leather.
Ful many a mayde, bright in bour,	Very many a maid, bright in bed-chamber,
And in his hand a launcegay,	And in his hand a light lance,
And many a clowe-gylofre;	And many a clove-gillyflower;
Sire Thopas fil in love-longynge,	Sir Thopas fell in a yearning for love,
To make his steede som solas,	To give his steed some rest,
Worthy to be my make	Worthy to be my mate
The contree of Fairye	The country of Fairy
Anon I sle thy steede	At once I will slay thy steed
Abyen it ful sowre.	Very bitterly pay for it.
And thurgh his fair berynge.	And due to his fair bearing.
With a geaunt with hevedes three,	With a giant with three heads,
And mede eek in a mazelyn,	And mead also in a maple drinking bowl,
For percynge of his herte;	To prevent piercing of his heart;
And there he swoor on ale and breed	And there he swore on ale and bread
That bodeth werre, and nothyng pees,	That foretells war, and nothing of peace,
Bothe knyght and lady free,	Both knight and noble lady,
Of roial chivalry!	Of royal chivalry!
His brighte helm was his wonger,	His bright helm was his pillow,
That, also wisly God my soule blesse,	That, as surely as God may bless my soul,
Sire, at o word, thou shalt no lenger ryme.	Sir, at one word, thou shalt no longer rime.
Of sondry folk, as I shal yow devyse.	By various folk, as I shall tell you.
But doutelees hir sentence is al oon.	But doubtless their essential meaning is all the same.
Shul ye nowher fynden difference	You shall nowhere find difference
For wel I woot it fareth so with me.	For well I know it fares so with me.
I wolde nevere eft comen in the snare.	I would never again come in the snare.
Unto the herte, ne koude in no manere	Unto the heart, could not in any way
A worthy knyght, that born was of Pavye,	A worthy knight, who was born in Pavia,
That day and nyght he dooth al that he kan	That day and night he does all he can
Thus seyde this olde knyght, that was so wys.	Thus said this old knight, who was so wise.
In love, which nys but childyssh vanytee.	In love, which is nothing but childish vanity.
Wel may his herte in joy and blisse habounde,	Well may his heart in joy and bliss abound,
"Ne take no wyf," quod he, "for housbondrye,	"Take no wife," said he, "for managing the household,
Ful lightly maystow been a cokewold."	Full easily canst thou be a cuckold."
But drede nat, if pleynly speke I shal:	But doubt not, if I shall speak plainly:
And saugh him al allone, bely-naked,	And saw him all alone, stark naked,
Hath but oon herte, in wele and in distresse.	Has but one heart, in prosperity and in distress.
"Do this," seith he; "Al redy, sire," seith she.	"Do this," says he; "All ready, sir," says she.
He may nat be deceyved, as I gesse,	He may not be deceived, as I guess,
Lo Judith, as the storie eek telle kan,	Lo Judith, as the story also can tell,
As seith Senek, above an humble wyf.	As says Seneca, above a humble wife.
No man hateth his flessh, but in his lyf	No man hates his flesh, but in his life
That is in mariage hony-sweete,	That is in honey-sweet marriage,
And that anoon in al the haste I kan.	And that at once in all the haste I can (do it).
I wol noon oold wyf han in no manere.	I will no old wife have in any way.
That with hem sholde I nevere lyve in reste.	That with them should I never live in rest.
And go streight to the devel whan I dye.	And go straight to the devil when I die.
If he ne may nat lyven chaast his lyf,	If he can not live his life chastely,
But sires, by youre leve, that am nat I.	But sirs, by your leave, that am not I.
As laurer thurgh the yeer is for to sene.	As laurel through the year is to be seen.
Of whiche that oon was cleped Placebo;	Of whom that one was called Placebo;
`And thanne shaltow nat repente thee.'	`And then shalt thou not repent.'
Yet hadde I nevere with noon of hem debaat.	Yet had I never with any of them disagreement.
Ye han youreselven shewed heer to-day	You have yourselves showed here to-day
Youre herte hangeth on a joly pyn!	Your heart hangs on a jolly pin (is very merry)!
And syn I oghte avyse me right wel	And since I ought to consider very carefully
Or riche, or poore, or elles mannyssh wood.	Or rich, or poor, or else man-crazy.
Preyse whoso wole a wedded mannes lyf,	Praise whosoever will a wedded man's life,
How that ye entren into mariage,	How that you enter into marriage,
"Wel," quod this Januarie, "and hastow ysayd?	"Well," said this January, "and hast thou spoken?
Be wedded whanne hym liste and where he wolde.	Be wedded when he pleased and where he would.
Gan Januarie inwith his thoght devyse	Did January within his thought imagine
And leet alle othere from his herte goon,	And let all others from his heart go,
Hym thoughte his choys myghte nat ben amended.	He thought his choice could not be bettered.
He was apoynted ther he wolde abyde.	He had decided on whom he would settle.
Suffiseth hym hir yowthe and hir beautee.	Her youth and her beauty are enough for him .
The which I wol reherce in youre presence.	Which I will tell in your presence.
So delicat, withouten wo and stryf,	So pleasing, without woe and strife,
Answerde anon right in his japerye;	Answered straight away in his mockery;
A wedded man hym grace to repente	A wedded man grace to repent himself
In mariage, ne nevere mo shal bee,	In marriage, nor never more shall be,
Of mariage, which we have on honde,	Of marriage, which we have in hand,
I trowe it were to longe yow to tarie,	I believe it would be too long to delay you,
And seyde his orisons, as is usage,	And said his prayers, as is the usage,
That Orpheus, ne of Thebes Amphioun,	That Orpheus, nor Amphioun of Thebes,
In libertee, and eek in mariage;	In liberty, and also in marriage;
To smal is bothe thy penne, and eek thy tonge,	Too small is both thy pen, and also thy tongue,
I may yow nat devyse al hir beautee.	I can not describe to you all her beauty.
That thilke nyght offenden hire moste he,	That that same night he must offend her,
As he best myghte, savynge his honour,	As he best could, so far as good manners allowed,
Almoost he swelte and swowned ther he stood,	Almost he fainted and swooned where he stood,
Lyk to the naddre in bosom sly untrewe,	Like to the sly untrue adder in one's bosom,
No lenger may the body of hym sojurne	No longer can its body sojourn
Wolde go to bedde; he wolde no lenger tarye.	Would go to bed; he would no longer tarry.
And they han doon right as he wol devyse.	And they have done right as he will command.
For he was shave al newe in his manere --	For he was all freshly shaved in his fashion --
In trewe wedlok coupled be we tweye,	In true wedlock we two are coupled,
And kiste his wyf, and made wantown cheere.	And kissed his wife, and acted lecherously.
Now day is come, I may no lenger wake."	Now day is come, I can no longer remain awake."
Now wol I speke of woful Damyan,	Now will I speak of woeful Damian,
So brenneth that he dyeth for desyr,	So burns that he dies for desire,
That Januarie hath wedded fresshe May	That January has wedded fresh May
As fressh as is the brighte someres day.	As fresh as is the bright summer's day.
"That me forthynketh," quod this Januarie,	"I am sorry about that," said this January,
And for that word hym blessed every man,	And for that word every man blessed him,
Have I no thyng but rested me a lite;	When I have done nothing but rested myself a little;
This Damyan, whan that his tyme he say,	This Damian, when he saw his opportunity,
But unto Januarie ycomen is she,	But unto January come is she,
Adoun by olde Januarie she lay,	Down by old January she lay,
Til evensong rong and that they moste aryse.	Until bell for evening prayers rang and they had to arise.
He deme of al, for I wole holde my pees.	May he judge of all, for I will hold my peace.
Lo, pitee renneth soone in gentil herte!	Lo, pity runs soon in gentle heart!
Right of hire hand a lettre made she,	In her own hand a letter made she,
So secrely that no wight of it wiste,	So secretly that no one knew of it,
(For craft is al, whoso that do it kan)	(For craft is all, whoever can do it)
His housynge, his array, as honestly	His lodging, his clothing, as suitably
The beautee of the gardyn and the welle	The beauty of the garden and the well
He baar alwey of silver a clyket,	He bore always of silver a latchkey,
To Januarie, ne to no creature.	To January, nor to any creature.
That haddest hym for thy fulle freend receyved?	Thou who had received him for thy closest friend ?
That som man bothe hire and hym had slayn.	That some man both her and him had slain.
That he nas jalous everemoore in oon;	From being more jealous all the time;
She wayteth whan hir herte wolde breste.	She expects that her heart would burst.
And she knew eek the fyn of his entente.	And she knew also the aim of his plan.
This fresshe May, that I spak of so yoore,	This fresh May, whom I spoke of formerly,
What sleighte is it, thogh it be long and hoot,	What trick is it, though (finding) it be long and painful,
In his gardyn, and no wight but they tweye,	In his garden, and no one (there) but those two,
No spot of thee ne knew I al my lyf.	No blemish on thee knew I all my life.
This Januarie, as blynd as is a stoon,	This January, as blind as is a stone,
Noght for no coveitise, doutelees,	Not for any greed, doubtless,
I prey yow first, in covenant ye me kisse;	I pray you first, to seal the contract, you kiss me;
Benyngnely to Januarie answerde,	Graciously to January answered,
That I ne sterve, as foule as womman may,	That I do not die, as foully as woman can,
But speke to us of untrust and repreeve."	Except to speak to us of distrust and reproof."
Of this matere, how he werchen shal.	Of this matter, what he must do.
That in that gardyn, in the ferther syde,	That in that garden, in the further side,
And right anon thus seyde he to his queene:	And right away thus said he to his queen:
Thus preiseth he yet the bountee of man:	Thus praises he yet the goodness of man:
His owene man shal make hym cokewold.	His own man shall make him cuckold.
That I shal yeven hire suffisant answere,	That I shall give her sufficient answer,
"What rekketh me of youre auctoritees?	"What do I care for your authorities?
But, sire, ne be nat wrooth, al be it so,	But, sir, be not angry, even though it be so,
How myghte he do a thyng that moore forbode is?	How might he do a thing that more forbidden is?
Or elles swelle til myn herte breke.	Or else swell until my heart breaks.
"And I," quod she, "a queene of Fayerye!	"And I," said she, "a queen of Fairy!
Where as this Damyan sitteth ful myrie	Where this Damian sits full merry
May han to fruyt so greet an appetit	May have for fruit so great an appetite
"Certes," quod he, "theron shal be no lak,	"Certainly," said he, "there shall be no lack,
And made hym se as wel as evere he myghte.	And made him see as well as he ever could.
"Out! Help! Allas! Harrow!" he gan to crye,	"Out! Help! Alas! Help!" he began to cry,
"Strugle?" quod he, "Ye, algate in it wente!	"Struggle?" said he, "Yea, indeed in it went!
And by my trouthe, me thoughte he dide thee so."	And by my troth, it seemed to me he did thee so."
"Ye, sire," quod she, "ye may wene as yow lest.	"Yea, sir," said she, "you may think as you please.
Ther may ful many a sighte yow bigile.	There may full many a sight deceive you.
Now, goode men, I pray yow to be glad.	Now, good men, I pray you to be glad.
But doutelees, as trewe as any steel	But doubtless, as true as any steel
And toold to hire of somme of this meynee --	And told to her by some of this company --
