Then I conclude thus, since God of heaven	Thanne conclude I thus, sith that God of hevene
"Of that liquid, if it be your wish."	"Of that water, if it be youre wil."
"Tell me the name of the secret stone."	"Telle me the name of the privee stoon."
"Let no man busy himself to seek this art,	"Lat no man bisye hym this art for to seche,
Unless it be with his brother's knowledge";	But it be with his brother knowlechyng";
But waste all that you can steal and carry away.	But wasten al that ye may rape and renne.
Though you search forever, you shall never find it.	Though ye prolle ay, ye shul it nevere fynde.
Lo! such a profit is in this pleasing game,	Lo! swich a lucre is in this lusty game,
That in good faith I believe that it is	That in good feith I trowe that it bee
After that day; and when this priest should	After that day; and whan that this preest shoolde
By God, they would have so great envy	By God, they wolden han so greet envye
And were it not for the act of friendship that before this you did	And nere the freendshipe that ye dide er this
And as I may deserve (to have) it from you,	And as I may deserve it unto yow,
Was never bird more glad at daybreak,	Was nevere brid gladder agayn the day,
With these three bars, which we have wrought,	With thise thre teynes, whiche that we han wroght,
And in the water groped noisily about to and fro,	And in the water rombled to and fro,
As he did before -- and all was nothing but a trick;	As he dide er -- and al nas but a jape;
He seemed friendly to those that did not know him,	He semed freendly to hem that knewe hym noght,
Is there any copper here?" said he.	Is ther any coper herinne?" seyde he.
And into the crucible it quickly fell.	And in the crosselet hastily it fel.
To him right away, and his powder cast in	To hym anon, and his poudre caste in
And this canon, at exactly the same time,	And this chanon, right in the meene while,
Some other day in my absence to try out	Another day assaye in myn absence
Was this priest, when he saw it was so.	Was this preest, whan he saugh it was so.
And from the fire he took up his material,	And fro the fir he took up his mateere,
He took the chalk and shaped it in the manner	He took the chalk and shoop it in the wise
How our business shall thrive and succeed.	How that oure bisynesse shal thryve and preeve.
He thought all the coals equally good,	He demed alle the coles yliche good,
Until the coals began to burn fast.	Til that the coles gonne faste brenne.
This is not arranged as it ought to be;	This is nat couched as it oghte be;
It distresses me when I speak of him.	It dulleth me whan that I of hym speke.
And therein was put of silver filings	And therinne put was of silver lemaille
To lay all the coals above	The coles for to couchen al above
And his master shut the door quickly,	And his maister shette the dore anon,
For ever to appear amongst folk.	Amonges folk for evere to appeere.
In the name of Christ, to become an alchemist.	In name of Crist, to wexe a philosofre.
And gave these three ounces to the canon;	And took thise ounces thre to the chanoun;
"Sir," said he to the priest, "have your man go	"Sire," quod he to the preest, "lat youre man gon
He has betrayed folks many a time;	He hath bitrayed folkes many tyme;
Therefore, to go to the conclusion,	Wherfore, to go to the conclusion,
How he can bring Christ's people to mischief.	How Cristes peple he may to meschief brynge.
By Saint Mary, for that I pray you heartily."	Marie, therof I pray yow hertely."
And sir," said he, "now some of my secrets,	And sire," quod he, "now of my pryvetee,
"What!" said this canon, "should I be untrue?	"What!" quod this chanoun, "sholde I be untrewe?
And took his leave, and went forth on his way,	And took his leve, and wente forth his weye,
This false canon came upon one day	This false chanon cam upon a day
In Londoun was a preest, an annueleer,	But in this case listen to what I shall say.
That among Cristes apostelles twelve	But also for many others; you know well
But worshipful chanons religious,	I will tell it here in your presence.
Whanne he commune shal with any wight,	And speak his words in so deceitful a manner,
Ther is a chanoun of religioun	Explicit prima pars
But every thing thah shines like gold	But al thyng which that shineth as the gold
To bring our experiment to an entirely different state,	To bryngen oure craft al in another plite,
"By God," said one, "something of our metal	"Pardee," quod oon, "somwhat of oure metal
"Well," said my lord, "there is no more to do;	"What," quod my lord, "ther is namoore to doone;
Some said it was due to the making of the fire;	Somme seyde it was long on the fir makyng;
And some of them sink into the ground --	And somme of hem synken into the ground --
Now he is gone, I dare say boldly --	Now he is goon, I dar seyn boldely --
And if a man will ask them privily	And if a man wole aske hem pryvely
They would sell them and spend it on this craft.	They wolde hem selle and spenden on this craft.
To be relieved by him afterward.	To be releeved by hym afterward.
Ah! Nay! Let be; the philosophers' stone,	A! Nay! Lat be; the philosophres stoon,
Yet I forgot to make enumeration	Yet forgat I to maken rehersaille
In learning of this mysterious foolish lore,	In lernyng of this elvysshe nyce loore,
For all the wealth he spends on this	For al the good he spendeth theraboute
The first spirit is called quicksilver,	The firste spirit quyksilver called is,
Clay made with horse or man's hair, and oil	Cley maad with hors or mannes heer, and oille
Our lamps burning both night and day,	Oure lampes brennyng bothe nyght and day,
Our urinals and our retorts,	Oure urynales and oure descensories,
And all the expenditure, in the name of twenty devils,	And al the cost, a twenty devel waye,
Of quicksilver, called raw mercury?	Of quyksilver, yclept mercurie crude?
And salt put in, and also pepper,	And salt yput in, and also papeer,
Our terms are so scholarly and so strange.	Oure termes been so clergial and so queynte.
And when he through his madness and folly	And whan he thurgh his madnesse and folye
That slippery science has made me so bare	That slidynge science hath me maad so bare
All that I had I have lost thereby,	Al that I hadde I have lost therby,
Now I wish to God my wit might suffice	Now wolde God my wit myghte suffise
Since he is gone, may the foul fiend kill him!	Syn he is goon, the foule feend hym quelle!
Thou slanderest me here in this company,	Thou sclaundrest me heere in this compaignye,
This Canon drew himself nearer and heard every thing	This Chanoun drough hym neer and herde al thyng
Or ten, or twelve, or many greater sums,	Or ten, or twelve, or manye sommes mo,
"Peter!" said he, "God give it bad luck,	"Peter!" quod he, "God yeve it harde grace,
Since he is so crafty and so sly.	Syn that he is so crafty and so sly.
That which is done too much, it will not turn out	That that is overdoon, it wol nat preeve
It is all dirty and tattered also.	It is al baudy and totore also.
He could turn all completely upside down,	He koude al clene turnen up-so-doun,
"Well," said our Host, "I pray thee, tell me then,	"Wel," quod oure Hoost, "I pray thee, tel me than,
He has taken on him many a great enterprise,	He hath take on hym many a greet emprise,
Thy lord is wise, and as I can well judge.	Thy lord were wys, and so I may wel deme.
Because I wanted to overtake you,	By cause that I wolde yow atake,
For he had ridden at more than a trot or a walk;	For he hadde riden moore than trot or paas;
He was by foam all flecked like a magpie.	He was of foom al flekked as a pye.
Before we had ridden a good five miles,	Er we hadde riden fully fyve mile,
And let him grieve, and weep, and wring his hands, and wail!	And lat hym care, and wepe, and wrynge, and waille!
For though thy husband be armed in mail,	For though thyn housbonde armed be in maille,
But eagerly take the governance to yourself.	But sharply taak on yow the governaille.
Griselda, for certainly he shall faille.	Grisildis, for in certein he shal faille.
In high mastery, and otherwise it would be a pity --	In heigh maistrie, and elles were it scathe --
But thing that will not be, let it be still."	But thyng that wol nat be, lat it be stille."
To gete thee freendes ay do thy travaille;	If thou be ugly, be lavish in thy expenditures;
Ay clappeth as a mille, I yow consaille.	Be fierce as is a tiger yonder in India;
But evere answereth at the countretaille.	Follow Echo, who holds no silence,
No wedded man so hardy be t'assaille	For which I cry in the hearing of all
Whos lyf and al hire secte God mayntene	For which here, for the love of the Wife of Bath --
And for oure beste is al his governaunce.	Before we were born, knew all our frailty;
Receyven al in gree that God us sent;	Unto a mortal man, well more we ought to
And herkneth what this auctour seith therfoore.	As it has been in old times long ago,
Unto a lord, oon of the worthieste	And richly his daughter married he
Thus hath this pitous day a blisful ende,	And there she was honored as she deserved.
Walter hire dooth so feithfully plesaunce	Until she has regained her composure.
Hire children two, whan she gan hem t'embrace,	And in her swoon so tightly holds she
Sith I stonde in youre love and in youre grace,	Now care I never to be dead right here;
She bothe hire yonge children to hire calleth,	For pitiful joy, and after her swooning
That thou hast lorn noon of thy children tweye.	Take them back, for now mayst thou not say
Til she out of hire mazednesse abreyde.	She fared as if she had suddenly awakened out of a sleep,
"This is ynogh, Grisilde myn," quod he;	To have pity upon her womanly steadfastness.
Moore tendrely, and, to my supposynge,	For she has been reared in her nurture
"How liketh thee my wyf and hire beautee?"	"Griselda," said he, as if it were a joke,
And koude swich honour and reverence,	That in such poor array was to be seen,
Right noght was she abayst of hire clothyng,	That was pertaining to the feast.
A ful greet fool is he that on yow leeveth."	Your judgment is false, your constancy proves evil;
And moore plesant, for hire heigh lynage.	And fairer fruit between them should fall,
Abouten undren gan this erl alighte,	Has every chamber prepared and his hall.
Ne nevere, for no wele ne no wo,	Without weakening, and shall evermore;
The chambres for t'arraye in ordinaunce	"I have no women capable, certainly,
Cam at his heste, and on hire knees hire sette,	Not with any proud thought in her heart,
And to the peples eres, alle and some,	Of which the news up sprang to high ranks and low,
And to hire housbonde evere meke and stable.	Discreet and without pride, ever honorable,
Biforn the folk, ne eek in hire absence,	That neither by her words nor her face,
Agayns his doghter hastily goth he,	And get rid of her as soon as ever he could.
Hir fader, that this tidynge herde anoon,	And in this time no word she spoke.
Lat it be stille, and bere it forth with thee."	"The smock," said he, "that thou hast on thy back,
Remembre yow, myn owene lord so deere,	Let me not like a worm go by the way.
Naked out of my fadres hous," quod she,	Within your chamber, dare I confidently say.
That I yow yaf myn herte in hool entente.	That ever in word or deed I shall repent
The whiche to me were hard now for to fynde.	It was my wretched clothing, in no way fair,
"And of youre newe wyf God of his grace	Another man as husband or as mate!
Foryelde it yow; ther is namoore to seye.	For that I thank you and God, to Whom I pray
The heighe God take I for my witnesse,	"And in this house, where you made me the lady --
With evene herte I rede yow t'endure	"No one can always have prosperity.
Another wyf, and crien day by day;	My people constrain me to take
Ful boistously hath seyd hire this sentence:	He on a certain day in the hearing of all
Arrayed eek ful fressh in his manere.	
But say the maiden should wedded be	But seye the mayden sholde ywedded be
This marquis written has in detail	This markys writen hath in special
Supposed full well that it had been right so;	Wenden ful wel that it hadde be right so;
How the pope, to restore tranquility for his people,	How that the pope, as for his peples reste,
Made them so that they hated him for this.	Made hem that they hym hatede therfore.
Desire in fact, except what her husband would want.	Wille in effect, but as hir housbonde wolde.
She was always the same in heart and in visage,	She was ay oon in herte and in visage,
But there are folk of such disposition	But ther been folk of swich condicion
He would have supposed that by some trickery,	He wolde have wend that of som subtiltee,
Her little son he would bury in earth	Hir litel sone he wolde in erthe grave
And forth he goes with sorrowful countenance,	And forth he goth with drery contenance,
I would do it without negligence;	I wolde it doon withouten necligence;
But first sickness, and after, woe and pain.	But first siknesse, and after, wo and peyne.
Right so I intend to deal with him secretly.	Right so thenke I to serve hym pryvely.
"Now say they thus: `When Walter is gone,	"Now sey they thus: `Whan Walter is agon,
O needless was she put to the test!	O nedelees was she tempted in assay!
Before she was with child, but, as God would,	Er she with childe was, but, as God wolde,
Were changed; but he never could find her	Were chaunged; but he nevere hire koude fynde
He should take it and explain to her this matter,	He sholde it take and shewe hire this mateere,
As lords do, when they will have their will;	As lordes doon, whan they wol han hir wille;
Bury this little body in some place	Burieth this litel body in som place
I believe that to a nurse in this case	I trowe that to a norice in this cas
And in her lap this little child she laid	And in hir barm this litel child she leyde
Suspect his face, suspect his word also;	Suspect his face, suspect his word also;
But men must by necessity unto their desires obey,	But men moote nede unto hire lust obeye,
In important matters, and also such folk well can	In thynges grete, and eek swich folk wel kan
Nor change my heart to another place."	Ne chaunge my corage to another place."
She said, "Lord, all is subject to your pleasure.	She seyde, "Lord, al lyth in youre plesaunce.
"And yet, God knows, this is full hateful to me;	"And yet, God woot, this is ful looth to me;
They say, to them it is great shame and woe	They seyn, to hem it is greet shame and wo
In which I have put you, as I believe,	In which that I have put yow, as I trowe,
To test a wife when there is no need,	To assaye a wyf whan that it is no nede,
This marquis in his heart longs so	This markys in his herte longeth so
People to save and every wrong to amend.	Peple to save and every wrong t'amende.
The public good could she promote.	The commune profit koude she redresse.
Thus Walter lowly -- nay, but royally --	Thus Walter lowely -- nay, but roially --
So benign and so worthy of reverence,	So benigne and so digne of reverence,
And worshipful that folk where she was born,	And worshipful that folk ther she was bore,
Conducted her; and thus the day they spend	Conveyed hire; and thus the day they spende
A crown on her head they have placed,	A corone on hire heed they han ydressed,
Whoever loves me; there is no more to say."	Whoso me loveth; ther is namoore to seye."
But as you desire yourself, right so desire I.	But as ye wole youreself, right so wol I.
"I say this: are you ready (to submit) with good heart	"I seye this: be ye redy with good herte
But shortly forth this matter to pursue,	But shortly forth this matere for to chace,
Their negotiation, which you shall after hear,	Hir tretys, which as ye shal after heere,
I will do nothing, you are my lord so dear;	I wol no thyng, ye be my lord so deere;
And all that pleases me, I dare well say	And al that liketh me, I dar wel seyn
And to the marquis she fetched her father.	And to the markys she hir fader fette.
Beside the threshold, in an ox's stall,	Biside the thresshfold, in an oxes stalle,
She thought, "I will stand with other maidens,	She thoghte, "I wole with othere maydens stonde,
With many a sound of varied melody,	With many a soun of sondry melodye,
Approaches, when this wedding should be,	Approcheth, that this weddyng sholde be,
Will he not wed? Alas! Alas, the times!	Wol he nat wedde? Allas! Allas, the while!
Of so young age, as well in manner as deed.	Of so yong age, as wel in chiere as dede.
That child may do to father's reverence.	That child may doon to fadres reverence.
And in great reverence and charity	And in greet reverence and charitee
But to speak of virtuous beauty,	But for to speke of vertuous beautee,
Had their beasts and their dwellings	Hadden hir beestes and hir herbergage,
Commands the feast to prepare,	Comaundeth for the feste to purveye,
For yet always the people somewhat dreaded,	For yet alwey the peple somwhat dredde,
For since I must forgo my liberty	For sith I shal forgoon my libertee
I entrust to him; he may do as he pleases.	I hym bitake; he may doon as hym leste.
To wed, as soon as ever I can.	To wedde me, as soone as evere I may.
Their meek prayer and their pitiful manner	Hir meeke preyere and hir pitous cheere
Born of the most noble and of the greatest (in rank)	Born of the gentilleste and of the meeste
In creeps age always, as still as stone,	In crepeth age alwey, as stille as stoon,
That you would desire to be a wedded man;	That for to been a wedded man yow leste;
Yet for as much as you, my lord so dear,	Yet for as muche as ye, my lord so deere,
He to the marquis said as you shall hear:	He to the markys seyde as ye shul heere:
Such as to hawk and hunt on every side.	As for to hauke and hunte on every syde.
Moreover he was, to speak of lineage,	Therwith he was, to speke as of lynage,
It seems to me a thing irrelevant,	Me thynketh it a thyng impertinent,
Piedmont and the country of Saluces,	Pemond and of Saluces the contree,
As Lynyan did with philosophy,	As Lynyan dide of philosophie,
And therefore will I obey you,	And therfore wol I do yow obeisance,
And let not thy tale put us to sleep.	Ne that thy tale make us nat to slepe.
This day I heard not one word from your tongue.	This day ne herde I of youre tonge a word.
Who helps him to waste and to consume	That helpeth hym to wasten and to sowke
"Well better is a rotten apple out of the store	"Wel bet is roten appul out of hoord
Even though he knows how to play on guitar or fiddle.	Al konne he pleye on gyterne or ribible.
That could better throw a pair of dice	That fairer koude caste a paire of dys
He loved the tavern better than the shop.	He loved bet the taverne than the shoppe.
And of a craft of food merchants was he.	And of a craft of vitailliers was hee.
But `a true jest is a bad jest,' as the Fleming says.	But `sooth pley, quaad pley,' as the Flemyng seith.
And many a Jack of Dover (a kind of pie) hast thou sold	And many a Jakke of Dovere hastow soold
I heard a miller better set to work (tricked).	Herde I a millere bettre yset a-werk.
"Ha! ha!" said he, "For Christ's passion,	"Ha! ha!" quod he, "For Cristes passion,
Thou hast paid well for my living expenses.	Thou hast ypayed wel for my vitaille.
Every one of you did nobly to the other.	Everich of yow dide gentilly til oother.
The sorrow of Dorigen he told him also;	The sorwe of Dorigen he tolde hym als;
"Yes, certainly, well and truly," said he.	"Yes, certes, wel and trewely," quod he.
For surely my debt shall be repaid	For sikerly my dette shal be quyt
At specific days, year by year, to pay,	At certeyn dayes, yeer by yeer, to paye,
Curses the time that ever he was born:	Curseth the tyme that evere he was born:
And be you sure, he was so well pleased	And be ye siker, he was so weel apayd
For any promise, and here I take my leave,	Of no biheste, and heere I take my leve,
To you, and also I see well your distress,	To yow, and eek I se wel youre distresse,
Who commanded her to keep all that she had promised,	That bad hire holden al that she had hight,
But thus they met, by chance or luck,	But thus they mette, of aventure or grace,
And when you have heard the tale, judge.	And whan that ye han herd the tale, demeth.
"Go forth right now with Dorigen," he said,	"Gooth forth anon with Dorigen," he sayde,
Than you should (do anything but) keep and save your pledged word.	But if ye sholde youre trouthe kepe and save.
Answered and said as I shall tell you:	Answerde and seyde as I shal yow devyse:
Intending ever that she would die.	Purposynge evere that she wolde deye.
The same of noble Portia I can tell;	The same of noble Porcia telle I may;
That for a similar case deprived herself of her life?	That for swich cas birafte hirself hir lyf?
O Scedasus, it is a very great pity	O Cedasus, it is ful greet pitee
There shall no person defile, if I can (help it)."	Ther shal no wight defoulen, if I may."
To live when she had lost her good name?	To lyven whan she hadde lost hir name?
Than be defiled, as it seems to me.	Than be defouled, as it thynketh me.
That loved a maiden, called Stymphalides,	That loved a mayden, heet Stymphalides,
And drowned themselves, as the books tell.	And dreynte hemselven, as the bookes telle.
When thirty tyrants, full of cursedness,	Whan thritty tirauntz, ful of cursednesse,
Save only death or else dishonor;	Save oonly deeth or elles dishonour;
She weeps, wails, all one day or two,	She wepeth, wailleth, al a day or two,
But well I know the rocks are away."	But wel I woot the rokkes been aweye."
And in my hand you pledged your word	And in myn hand youre trouthe plighten ye
You slay me guiltless for sheer pain.	Ye sle me giltelees for verray peyne.
And when he saw his time, immediately he,	And whan he saugh his tyme, anon-right hee,
Whether he shall have his love or fare badly,	Wher he shal han his love or fare amys,
And in which planet's face and term (zodiacal divisions), and everything;	And in whos face, and terme, and everydeel;
And his table for computing motions (of the planets)	And his proporcioneles convenientz
That the rocks of Brittany were away,	That of Britaigne the rokkes were aweye,
And prays him to work diligently	And preyeth hym to doon his diligence
But now in Capricorn he alights down,	But now in Capricorn adoun he lighte,
His woeful heart of suffering had relief.	His woful herte of penaunce hadde a lisse.
This wide world, which men say is round,	This wyde world, which that men seye is round,
These amorous folk sometime must have their rest."	Thise amorous folk somtyme moote han hir reste."
They sat still, and no person (was there) but these three.	They seten stille, and no wight but they thre.
Then he saw knights jousting in a plain;	Tho saugh he knyghtes justyng in a playn;
Aurelius in his life saw never a one.	Aurelius in his lyf saugh nevere noon.
He told them all that was in their intention.	He tolde hem al that was in hire entente.
To Orleans that he leaped up immediately,	To Orliens that he up stirte anon,
To man's sight, that all the rocks black	To mannes sighte, that alle the rokkes blake
Sometimes a vine, and grapes white and red;	Somtyme a vyne, and grapes white and rede;
"My brother shall be cured speedily;	"My brother shal be warisshed hastily;
Had covertly left upon his desk;	Hadde prively upon his desk ylaft;
That while he was at Orleans in France --	That whiles he was at Orliens in Fraunce --
He dared say any word of this matter.	Of this matere he dorste no word seyn.
But dances, jousts, makes her good cheer;	But daunceth, justeth, maketh hire good cheere;
As he that was of chivalry the flower,	As he that was of chivalrie the flour,
Lord Phoebus, see the tears on my cheek,	Lord Phebus, se the teeris on my cheke,
At no faster speed as you for these two years.	No faster cours than ye thise yeres two.
Which shall be in the sign of the Lion,	Which in the signe shal be of the Leon,
Yet empress above him is she),	Yet emperisse aboven hym is she),
Lo, lord! My lady has sworn my death	Lo, lord! My lady hath my deeth ysworn
He knew not what he spoke, but thus he said;	He nyste what he spak, but thus he seyde;
This is as much to say that it was night --	This is as muche to seye as it was nyght --
And with a sorrowful heart he thus answered:	And with a sorweful herte he thus answerde:
Have here my pledged word, in all that is in my power."	Have heer my trouthe, in al that evere I kan."
But after that in play thus she said:	But after that in pley thus seyde she:
Have mercy, sweet, or you will make me die!"	Have mercy, sweete, or ye wol do me deye!"
Providing that I knew it might gladden your heart,	So that I wiste it myghte youre herte glade,
In such a manner as a man that asks for grace;	In swich a wise as man that asketh grace;
Songs, complaints, roundels, virelays,	Songes, compleintes, roundels, virelayes,
Who was called Aurelius,	Which that ycleped was Aurelius,
As to my judgement, than is the month of May.	As to my doom, than is the month of May.
After dinner they go to dance,	At after-dyner gonne they to daunce,
This garden full of leaves and of flowers;	This gardyn ful of leves and of floures;
They lead her by rivers and by springs,	They leden hire by ryveres and by welles,
But that same God that made wind to blow	But thilke God that made wynd to blowe
Have rocks slain, although their names are forgotten,	Han rokkes slayn, al be they nat in mynde,
But, Lord, these grisly fiendish black rocks,	But, Lord, thise grisly feendly rokkes blake,
And cast her eyes downward from the brink.	And caste hir eyen dounward fro the brynke.
And often with her friends she walks	And often with hire freendes walketh shee
Has sent her letters home (telling) of his welfare,	Hath sent hire lettres hoom of his welfare,
All to make her leave her sadness.	Al for to make hire leve hire hevynesse.
As do these noble wives when it pleases them.	As doon thise noble wyves whan hem liketh.
That was called Arveragus of Kayrrud,	That of Kayrrud was cleped Arveragus,
The which accords to the law of love.	The which that lawe of love acordeth to.
To live in ease, promised her forbearance,	To lyve in ese, suffrance hire bihight,
You shall learn it, whether you want to or not;	Ye shul it lerne, wher so ye wole or noon;
Women, by nature, desire liberty,	Wommen, of kynde, desiren libertee,
Sir, I will be your humble true wife --	Sire, I wol be youre humble trewe wyf --
Against her will, nor show her jealousy,	Agayn hir wyl, ne kithe hire jalousie,
But at the last she, for his worthiness,	But atte laste she, for his worthynesse,
Here begins the Franklin's Tale.	Here bigynneth the Frankeleyns Tale
I learned never rhetoric, certainly;	I lerned nevere rethorik, certeyn;
These old noble Bretons in their days	Thise olde gentil Britouns in hir dayes
"The lion sits in his ambush always	"The leoun sit in his awayt alway
According to the text of Christ, Paul, and John,	After the text of Crist, Poul, and John,
Where thou shalt know of our secrets	Where thou shalt knowen of oure privetee
Is this your will in earnest that you say?"	Is this youre wyl in ernest that ye seye?"
I paid at our court the fine for thy punishment."	I payde at hoom for thy correccioun."
I have not twelve pence within my possession.	Ne have I nat twelf pens withinne myn hoold.
To such thing as men will bring against me?"	To swich thyng as men wole opposen me?"
Upon pain of excommunication, look that thou be	Up peyne of cursyng, looke that thou be
Or I will summon her unto our court;	Or I wol sompne hire unto oure office;
Here may you see, my own dear brother,	Heere may ye se, myn owene deere brother,
Ask him thyself, if thou not believe me;	Axe hym thyself, if thou nat trowest me;
The devil have all, both horses and cart and hay!"	The devel have al, bothe hors and cart and hey!"
And right at the entrance of the town,	And right at the entryng of the townes ende,
My troth will I hold to my brother,	My trouthe wol I holde to my brother,
For thou shalt, by thine own experience,	For thou shalt, by thyn owene experience,
Sometime we dissemble, and sometimes we arise	Somtyme we feyne, and somtyme we aryse
When he withstands our temptation,	Whan he withstandeth oure temptacioun,
Without him we have no power, certainly,	Withouten hym we have no myght, certayn,
And yet I gained nothing in this day.	And yet ne wan I nothyng in this day.
A lousy conjurer can deceive thee,	A lowsy jogelour kan deceyve thee,
I supposed you were truly a yeoman.	I wende ye were a yeman trewely.
"Brother," said he, "wilt thou that I thee tell?	"Brother," quod he, "wiltow that I thee telle?
What I can get in private secretly,	What I may gete in conseil prively,
My lord is hard to me and niggardly,	My lord is hard to me and daungerous,
"Now, brother," said this summoner, "I you pray,	"Now, brother," quod this somonour, "I yow preye,
This summoner, who was as full of idle speech	This somonour, which that was as ful of jangles
I am unknown in this country;	I am unknowen as in this contree;
Said this yeoman, "Wilt thou travel far today?"	Seyde this yeman, "Wiltow fer to day?"
Rode to summon an old widow, an old crone,	Rood for to somne an old wydwe, a ribibe,
Certainly he knew of more ways of stealing	Certeyn he knew of briberyes mo
Or Jakke, or Rauf, or whoever it was	Or Jakke, or Rauf, or whoso that it were
He could summon, on pain of excommunication,	He koude somne, on peyne of Cristes curs,
And tell everything, my own master dear."	Ne spareth nat, myn owene maister deere."
For though this Summoner were mad as a hare,	For thogh this Somonour wood were as an hare,
For ere the bishop caught them with his crozier,	For er the bisshop caughte hem with his hook,
Of robbing churches, and of wills,	Of chirche reves, and of testamentz,
Our Host answered, "Quiet, no more of this!"	Oure Hoost answerde, "Pees, namoore of this!"
In this company we will have no arguments.	In compaignye we wol have no debaat.
But if it pleases this company,	But if it lyke to this compaignye,
No churlish word as yet to him spoke he.	No vileyns word as yet to hym spak he.
He said, "Since I must begin the game,	He seyde, "Syn I shal bigynne the game,
And shortly to tell as it was,	And shortly for to tellen as it was,
Whosoever may be rebel to my judgment	Whoso be rebel to my juggement
Our Host arose, and was the rooster of us all (awakened us).	Up roos oure Hoost, and was oure aller cok,
And that he would be our governor,	And that he wolde been oure governour,
I will myself gladly ride with you,	I wol myselven goodly with yow ryde,
On the way to Canterbury, that is what I mean,	To Caunterbury-ward, I mene it so,
Hold up your hands, without more speech."	Hoold up youre hondes, withouten moore speche."
For truly, it is no comfort nor mirth	For trewely, confort ne myrthe is noon
For by my word, if I shall not lie (I must say),	For by my trouthe, if that I shal nat lye,
He was a large man with prominent eyes --	A large man he was with eyen stepe --
Also I pray you to forgive it to me,	Also I prey yow to foryeve it me,
Every single word, if it be in his power,	Everich a word, if it be in his charge,
And after that I will tell of our journey	And after wol I telle of our viage
To win silver, as he very well knew how;	To wynne silver, as he ful wel koude;
In one day he got himself more money	Upon a day he gat hym moore moneye
There was no other pardoner like him.	Ne was ther swich another pardoner.
With hair unbound, save for his cap, he rode all bare-headed.	Dischevelee, save his cappe, he rood al bare.
This Summoner harmonized with him in a strong bass;	This Somonour bar to hym a stif burdoun;
In his control he had as he pleased	In daunger hadde he at his owene gise
And if he found anywhere a good fellow,	And if he foond owher a good felawe,
Can call out "Walter" as well as the pope can.	Kan clepen "Watte" as wel as kan the pope.
Nor of the knobs sitting on his cheeks.	Nor of the knobbes sittynge on his chekes.
There was a SUMMONER with us in that place,	A SOMONOUR was ther with us in that place,
In youth he had learned a good craft:	In youthe he hadde lerned a good myster:
There was no farm manager, nor herdsman, nor other servant,	Ther nas baillif, ne hierde, nor oother hyne,
He well knew how to keep a granary and a storage bin;	Wel koude he kepe a gerner and a bynne;
Or live as economically as it pleased him to desire;	Or lyve as scarsly as hym list desire;
Now is not that a very fair grace of God	Now is nat that of God a ful fair grace
And yet he had a thumb of gold, indeed.	And yet he hadde a thombe of gold, pardee.
And moreover broad, as though it were a spade.	And therto brood, as though it were a spade.
A SUMMONER, and a PARDONER also,	A SOMNOUR, and a PARDONER also,
He loved God best with all his whole heart	God loved he best with al his hoole herte
He would rebuke him sharply at that time.	Hym wolde he snybben sharply for the nonys.
So that the wolf did not make it go wrong;	So that the wolf ne made it nat myscarie;
And it is a shame, if a priest is concerned:	And shame it is, if a prest take keep,
In sickness or in trouble to visit	In siknesse nor in meschief to visite
He was gracious, and wonderfully diligent,	Benygne he was, and wonder diligent,
And on her feet a pair of sharp spurs.	And on hir feet a paire of spores sharpe.
And she had been three times at Jerusalem;	And thries hadde she been at Jerusalem;
Her kerchiefs were very fine in texture;	Hir coverchiefs ful fyne weren of ground;
Since in medicine gold is a restorative for the heart,	For gold in phisik is a cordial,
Averroes, John the Damascan, and Constantine,	Averrois, Damascien, and Constantyn,
The cause known, and the source of his (patient's) harm,	The cause yknowe, and of his harm the roote,
To speak of medicine and of surgery,	To speke of phisik and of surgerye,
His harbors, and positions of his moon, his navigation,	His herberwe, and his moone, his lodemenage,
About his neck, down under his arm.	Aboute his nekke, under his arm adoun.
He knew how to roast, and boil, and broil, and fry,	He koude rooste, and sethe, and broille, and frye,
For they had enough possessions and income,	For catel hadde they ynogh and rente,
And they were all clothed in one livery	And they were clothed alle in o lyveree
In his hall his dining table always	His table dormant in his halle alway
His house was never without baked pies	Withoute bake mete was nevere his hous,
As to his temperament, he was dominated by the humor blood.	Of his complexioun he was sangwyn.
He had in Year Books all the cases and decisions	In termes hadde he caas and doomes alle
He seemed such, his words were so wise.	He semed swich, his wordes weren so wise.
He took most care and paid most heed to study.	Of studie took he moost cure and moost heede.
For he would rather have at the head of his bed	For hym was levere have at his beddes heed
Truly, he was a worthy man indeed,	For sothe he was a worthy man with alle,
His boots were buckled handsomely and elegantly.	His bootes clasped faire and fetisly.
Which was round as a bell fresh from the clothespress.	That rounded as a belle out of the presse.
For though a widow had not a shoe,	For thogh a wydwe hadde noght a sho,
To have acquaintance with sick lepers.	To have with sike lazars aqueyntaunce.
And certainly he had a merry voice:	And certeinly he hadde a murye note:
For to give to a poor order (of friars)	For unto a povre ordre for to yive
Very well beloved and familiar was he	Ful wel biloved and famulier was he
He was not pale as a tormented spirit.	He was nat pale as a forpyned goost.
And to fasten his hood under his chin,	And for to festne his hood under his chyn,
Always to pore upon a book in the cloister,	Upon a book in cloystre alwey to poure,
This same Monk let old things pass away,	This ilke Monk leet olde thynges pace,
There was a MONK, an extremely fine one,	A MONK ther was, a fair for the maistrie,
It was almost nine inches broad, I believe;	It was almoost a spanne brood, I trowe;
Caught in a trap, if it were dead or bled.	Kaught in a trappe, if it were deed or bledde.
Of grease, when she had drunk her drink.	Of grece, whan she dronken hadde hir draughte.
In the manner of Stratford at the Bow,	After the scole of Stratford atte Bowe,
A Christopher-medal of bright silver on his breast.	A Cristopher on his brest of silver sheene.
He carried under his belt very properly	Under his belt he bar ful thriftily
He knew how to make songs and well compose (the words),	He koude songes make and wel endite,
And he had been for a time on a cavalry expedition	And he hadde been somtyme in chyvachie
He wore a tunic of coarse cloth	Of fustian he wered a gypon
At one time with the lord of Balat	Somtyme with the lord of Palatye
No Christian man of his rank so often.	No Cristen man so ofte of his degree.
To ride out, he loved chivalry,	To riden out, he loved chivalrie,
But nonetheless, while I have time and opportunity,	But nathelees, whil I have tyme and space,
Of various sorts of people, by chance fallen	Of sondry folk, by aventure yfalle
And specially from every shire's end	And specially from every shires ende
When the West Wind also with its sweet breath,	Whan Zephirus eek with his sweete breeth
And Emelye loves him so tenderly,	And Emelye hym loveth so tendrely,
Come near, and take your lady by the hand."	Com neer, and taak youre lady by the hond."
Let your womanly pity now be seen.	Lat se now of youre wommanly pitee.
And look now, where most sorrow is herein,	And looketh now, wher moost sorwe is herinne,
Of the welfare of him, who loved them so well?	Of his welfare, that loved hem so weel?
Than when his name is faded because of age,	Than whan his name apalled is for age,
And take it well what we may not escape,	And take it weel that we may nat eschue,
Nothing helps there; all goes that same way.	Ther helpeth noght; al goth that ilke weye.
Eventually it is worn away as it lies by the way.	Yet wasteth it as it lyth by the weye.
That types of being and natural processes	That speces of thynges and progressiouns
Then one can by this order well discern	Thanne may men by this ordre wel discerne
In definite bounds, from which they may not flee.	In certeyn boundes, that they may nat flee.
Before any word came from his wise breast,	Er any word cam fram his wise brest,
To have alliance with certain countries,	To have with certein contrees alliaunce,
I will not tell also how they go	I wol nat tellen eek how that they goon
Upon the left hand, with a loud shouting,	Upon the left hand, with a loud shoutynge,
Nor how she swooned when men made the fire,	Ne how she swowned whan men made the fyr,
Nor how the fire was laid first with straw,	Ne how the fyr was couched first with stree,
Maple, thorn, beech, hazel, yew, dogwood --	Mapul, thorn, bech, hasel, ew, whippeltree --
Much labor and full great preparation	Heigh labour and ful greet apparaillynge
Which was all spread with black, and wonderfully high	That sprad was al with blak, and wonder hye
There sat folk, of which one carried his (Arcite's) shield,	Ther seten folk, of whiche oon baar his sheeld,
With waving beard and rough hair sprinkled with ashes,	With flotery berd and ruggy, asshy heeres,
And of the same material he clad Arcite;	And of the same suyte he cladde Arcite;
He would make a fire in which the rite	He wolde make a fyr in which the office
Duke Theseus, with all his careful attention,	Duc Theseus, with al his bisy cure,
"Right as there died never a man," said he,	"Right as ther dyed nevere man," quod he,
To Troy. Alas, the lamentation that was there,	To Troye. Allas, the pitee that was ther,
When their husbands are gone from them,	Whan that hir housbondes ben from hem ago,
Nor do I wish to tell such beliefs	Ne me ne list thilke opinions to telle
Only the intellect, nothing else,	Oonly the intellect, withouten moore,
In this world right now I know no one	As in this world right now ne knowe I non
"I have here with my cousin Palamon	"I have heer with my cosyn Palamon
Alas, the death! Alas, my Emelye!	Allas, the deeth! Allas, myn Emelye!
And Palamon, who was his dear cousin.	And Palamon, that was his cosyn deere.
And every muscle down in his breast	And every lacerte in his brest adoun
The breast of Arcite swells, and the pain	Swelleth the brest of Arcite, and the soore
The victory (is given) as well to one side as to the other,	The gree as wel of o syde as of oother,
Nor to be led by force unto the stake	Ne to be lad by force unto the stake
Medicines made of herbs, and also of sage	Fermacies of herbes, and eek save
Although this accident had happened,	Al be it that this aventure was falle,
The blood was so run in his face.	So was the blood yronnen in his face.
And was all his source of pleasure, in his heart.	And was al his chiere, as in his herte.
Are in their happiest state for joy of dan Arcite.	Been in hire wele for joye of daun Arcite.
What now can fair Venus do above?	What kan now faire Venus doon above?
That must no more go again to fight?	That moot namoore goon agayn to fighte?
And in the rescue of this Palamon	And in the rescus of this Palamoun
As Palamon to slay his foe Arcite.	As Palamon to sleen his foo Arcite.
Many times these two Thebans have	Ful ofte a day han thise Thebanes two
There strong steeds stumble, and down goes all,	Ther stomblen steedes stronge, and doun gooth al,
In goes the sharp spur into the flank.	In gooth the sharpe spore into the syde.
So evenly were they chosen, as I estimate.	So evene were they chosen, for to gesse.
With red banner is entered right away;	With baner reed is entred right anon;
One after another, according to their rank.	Of oon and oother, after hir degree.
"God save such a lord, that is so good	"God save swich a lord, that is so good
That shall be placed on either side;	That shal ben ordeyned on either syde;
No man therefore, upon punishment of loss of life,	No man therfore, up peyne of los of lyf,
A herald on a scaffold made a "Ho!"	An heraud on a scaffold made an "Oo!"
The great Theseus, who was awakened of his sleep	The grete Theseus, that of his sleep awaked
The palace full of people everywhere,	The paleys ful of peple up and doun,
Nailing heads to the spear-shafts, and buckling helms;	Nailynge the speres, and helmes bokelynge;
There was in hostelries all about,	Ther was in hostelryes al aboute,
Great was the feast in Athens that day,	Greet was the feeste in Atthenes that day,
Though Mars shall help his knight, yet nonetheless	Though Mars shal helpe his knyght, yet nathelees
Mine is the ruin of the high halls,	Myn is the ruyne of the hye halles,
"My dear daughter Venus," said Saturn,	"My deere doghter Venus," quod Saturne,
Until the pale Saturn the hostile,	Til that the pale Saturnus the colde,
Very low and faint, that said thus, "Victory!"	Ful lowe and dym, and seyde thus, "Victorie!"
And also the doors, clattered very fast,	And eek the dores, clatereden ful faste,
Eternal fire I will provide before thee (on your altar).	Eterne fir I wol bifore thee fynde.
For that same fire that once burned thee,	For thilke fyr that whilom brente thee,
I am young and ignorant, as thou knowest,	I am yong and unkonnynge, as thow woost,
For that same pain and that same hot fire	For thilke peyne and thilke hoote fir
"O strong god, who in the cold reigns	"O stronge god, that in the regnes colde
I put me in thy protection,	I putte me in thy proteccioun,
But unto which of them I may not tell.	But unto which of hem I may nat telle.
For she did not know what it signified,	For she ne wiste what it signyfied,
But suddenly she saw a curious sight,	But sodeynly she saugh a sighte queynte,
Or if my destiny is shaped so	Or if my destynee be shapen so
For those three forms that thou hast in thee.	For tho thre formes that thou hast in thee.
Which Acteon paid for cruelly.	That Attheon aboughte cruelly.
And did her duties, as men can behold	And dide hir thynges, as men may biholde
Washed her body with water of a well.	Hir body wessh with water of a welle.
Up rose the sun, and up rose Emelye	Up roos the sonne, and up roos Emelye
Full piteously, with all due ceremony,	Ful pitously, with alle circumstaunces,
I will do sacrifice and kindle fires.	I wol doon sacrifice and fires beete.
Of Emelye, and die in thy service.	Of Emelye, and dye in thy servyse.
Consider all this and have pity upon my pain,	Considere al this and rewe upon my soore,
Thou maker of joy of the mount of Citheron,	Thow gladere of the mount of Citheron,
With pious heart and with a noble disposition,	With hooly herte and with an heigh corage,
Nor who speaks most feelingly of love;	Ne who moost felyngly speketh of love;
He feasts them, and does such great labor	He festeth hem, and dooth so greet labour
Were gathered in this noble company,	Were gadered in this noble compaignye,
His beard had well begun to spring;	His berd was wel bigonne for to sprynge;
A short cloak hanging upon his shoulder,	A mantelet upon his shulder hangynge,
He had a hundred lords in his company,	An hundred lordes hadde he in his route,
His long hair was combed behind his back;	His longe heer was kembd bihynde his bak;
And he looked about like a griffin (with an eagle's head),	And lik a grifphon looked he aboute,
One of them will be well armed on his legs,	Som wol ben armed on his legges weel,
Were it in England or elsewhere,	Were it in Engelond or elleswhere,
To speak of knighthood of (the deeds of) their hand,	As for to speke of knyghthod of hir hond,
But I will stop speaking of Theseus a little while,	But stynte I wole of Theseus a lite,
A woman in childbirth was before her;	A womman travaillynge was hire biforn;
There I saw many another wonderful story,	Ther saugh I many another wonder storie,
I mean not the goddess Diana,	I mene nat the goddesse Diane,
To tell you all the description.	To telle yow al the descripsioun.
And over his head there shine two figures	And over his heed ther shynen two figures
Although at that same time they were unborn,	Al be that thilke tyme they were unborn,
He lay down full low under the wheel.	Under the wheel ful lowe he lay adoun.
The corpse in the woods, with (its) throat cut;	The careyne in the busk, with throte ycorve;
Strife, with bloody knife and sharp menacing.	Contek, with blody knyf and sharp manace.
Every pillar, to support the temple,	Every pyler, the temple to sustene,
Wrought all of burnished steel, of which the entry	Wroght al of burned steel, of which the entree
In that same cold, frosty region	In thilke colde, frosty regioun
Before her stood her son Cupid;	Biforn hire stood hir sone Cupido;
One or two examples here suffice,	Suffiseth heere ensamples oon or two,
Nor yet the great strength of Hercules --	Ne yet the grete strengthe of Ercules --
Of love, which I recounted and shall recount,	Of love, which that I rekned and rekne shal,
That love's servants endure in this life;	That loves servantz in this lyf enduren;
Has Theseus had made in noble style.	Hath Theseus doon wroght in noble wyse.
He has eastward, upon the gate above,	He estward hath, upon the gate above,
Eastward there stood a gate of white marble,	Estward ther stood a gate of marbul whit,
Of Theseus, who goes (about) so busily	Of Theseus, that gooth so bisily
The joy that is made in the place	The joye that is maked in the place
And as God may surely have pity on my soul	And God so wisly on my soule rewe
All ready to decide the right to her by battle.	Al redy to darreyne hire by bataille.
As is ordained for him, and listen in what way;	As hym is shape, and herkneth in what wyse;
I speak for my sister Emelye,	I speke as for my suster Emelye,
Nor make war upon me at any time,	Ne make werre upon me nyght ne day,
I know it by my own experience very long ago,	I woot it by myself ful yore agon,
Their wages and their fees for their service!	Hir wages and hir fees for hir servyse!
And could have lived royally in Thebes,	And myghte han lyved in Thebes roially,
He began to look up with bright eyes	He gan to looken up with eyen lighte
And softly to himself he said, "Fie	And softe unto hymself he seyde, "Fy
He has considered shortly, in brief,	He hath considered shortly, in a clause,
For they were gentle men of high rank,	For gentil men they were of greet estaat,
And said, "This is a brief (easy) decision.	And seyde, "This is a short conclusioun.
I make plainly my confession	I make pleynly my confessioun
Or slay him first, for though thou little knowest it,	Or sle hym first, for though thow knowest it lite,
As it would be in a properly conducted duel,"	As it were in a lystes roially."
But who they were, he knew nothing.	But what they were, no thyng he ne woot.
And (flee) over a brook, and so forth on his way.	And over a brook, and so forth on his weye.
The day was clear, as I have told before this,	Cleer was the day, as I have toold er this,
I mean this now in regard to mighty Theseus,	This mene I now by myghty Theseus,
The destiny, general minister,	The destinee, ministre general,
And after that, with sharp strong spears	And after that, with sharpe speres stronge
And thinks, "Here comes my mortal enemy!	And thynketh, "Heere cometh my mortal enemy!
And on his horse, alone as he was born,	And on his hors, allone as he was born,
O Cupid, devoid of all kindness to others!	O Cupide, out of alle charitee!
And bring armor right enough for thee;	And bryngen harneys right ynough for thee;
Rather thou shouldest die of my hand.	That thou ne sholdest dyen of myn hond.
I doubt not that either thou shalt dye,	I drede noght that outher thow shalt dye,
And art of my blood, and sworn to be in my confidence,	And art my blood, and to my conseil sworn,
A long time, and afterwards he leaped up.	A longe tyme, and after he up sterte.
And in addition to all this, to slay me utterly	And over al this, to sleen me outrely
That he who is my mortal enemy,	That he that is my mortal enemy,
How long, Juno, through thy cruelty,	How longe, Juno, thurgh thy crueltee,
Now up, now down, like a bucket in a well.	Now up, now doun, as boket in a welle.
It is very good for a man to act calmly,	It is ful fair a man to bere hym evene,
And from his war horse, with an eager heart,	And from his courser, with a lusty herte,
Has ridden into the fields to amuse himself,	Is riden into the feeldes hym to pleye,
And fiery Phoebus rises up so bright	And firy Phebus riseth up so bright
Toward Thebes, to pray his friends	To Thebes-ward, his freendes for to preye
That all that night, though men would shake him,	That al that nyght, thogh that men wolde him shake,
The third night (as old books say,	The thridde nyght (as olde bookes seyn,
Wasted by suffering, what for woe and for distress.	Forpyned, what for wo and for distresse.
From year to year, very secretly, his income;	From yeer to yeer, ful pryvely his rente;
They said that it would be a act of charity	They seyden that it were a charitee
For he was young and mighty indeed,	For he was yong and myghty for the nones,
To Athens he is gone the nearest way.	To Atthenes is he goon the nexte way.
That, since his face was so disfigured	That, sith his face was so disfigured
And with that word Arcite awoke and leaped up.	And with that word Arcite wook and sterte.
At Thebes, in his country, as I said,	At Thebes, in his contree, as I seyde,
Not only like the lover's malady	Nat oonly lik the loveris maladye
His eyes sunken and grisly to behold,	His eyen holwe and grisly to biholde,
Now judge as it pleases you, you who know (of such things),	Now demeth as yow liste, ye that kan,
In chains and in fetters to be dead;	In cheynes and in fettres to been deed;
For jealousy and fear of this Arcite."	For jalousie and fere of hym Arcite."
The answer to this I leave to theologians,	The answere of this lete I to dyvynys,
"What (sort of) governance is in this foreknowledge,	"What governance is in this prescience,
Then said he, "O cruel gods that govern	Thanne seyde he, "O crueel goddes that governe
And art a lord, thy advantage is great,	And art a lord, greet is thyn avauntage
Thou walkest freely now in Thebes,	Thow walkest now in Thebes at thy large,
Since I can not see you, Emelye,	Syn that I may nat seen you, Emelye,
But he does not know which is the right way to it,	But he noot which the righte wey is thider,
That gives them full often in many a manner	That yeveth hem ful ofte in many a gyse
Thou mayest sometime attain thy desire.	Thow maist to thy desir somtyme atteyne.
Would have sufficed right enough for me.	Wolde han suffised right ynough for me.
He said, "Alas that day that I was born!	He seyde, "Allas that day that I was born!
In any country of this Theseus,	In any contree of this Theseus,
And had known him at Thebes year after year,	And hadde hym knowe at Thebes yeer by yere,
Since that same time that they were little children,	Syn thilke day that they were children lite,
Love, if it please thee, for I love and always shall;	Love, if thee list, for I love and ay shal;
To stand in her good graces; no more shall I;	To stonden in hir grace; namoore shal I;
Knowest thou not well the old clerks' saying,	Wostow nat wel the olde clerkes sawe,
"Thou shalt," said he, "be rather false than I;	"Thow shalt," quod he, "be rather fals than I;
To love my lady, whom I love and serve,	To love my lady, whom I love and serve,
That never, though we had to die by torture,	That nevere, for to dyen in the peyne,
This Palamon, when he heard those words,	This Palamon, whan he tho wordes herde,
Where this lady roamed to and fro,	Wher as this lady romed to and fro,
And with that he fell down on his knees,	And therwithal on knees doun he fil,
"Cousin, truly, concerning this opinion	"Cosyn, for sothe, of this opinioun
Why didst thou cry out? Who has done thee offence?	Why cridestow? Who hath thee doon offence?
That he was born, full often he said, "alas!"	That he was born, ful ofte he seyde, "allas!"
And Palamon, this woeful prisoner,	And Palamoun, this woful prisoner,
She gathers flowers, mixed white and red,	She gadereth floures, party white and rede,
The season urges on every gentle heart,	The sesoun priketh every gentil herte,
This passes year by year and day by day,	This passeth yeer by yeer and day by day,
To Athens, to dwell in prison	To Atthenes, to dwellen in prisoun
Of which two one was called Arcite,	Of whiche two Arcita highte that oon,
Still in that field he took all night his rest,	Stille in that feeld he took al nyght his reste,
To do obsequies, as was then the custom.	To doon obsequies, as was tho the gyse.
Until he came to Thebes and dismounted	Til that he cam to Thebes and alighte
Unto the town of Athens to dwell,	Unto the toun of Atthenes to dwelle,
How Creon was treated by Theseus	How Creon was of Theseus yserved
With compassionate heart, when he heard them speak.	With herte pitous, whan he herde them speke.
Of all our lords who are slain,	Of alle oure lordes whiche that been yslawe,
Who died at Thebes -- cursed be that day! --	That starf at Thebes -- cursed be that day! --
Who has not been a duchesse or a queen.	That she ne hath been a duchesse or a queene.
After she had swooned with (so) deadly a countenance,	Whan she hadde swowned with a deedly cheere,
And of this cry they would not ever stop	And of this cry they nolde nevere stenten
This duke, of whom I make mention,	This duc, of whom I make mencioun,
And of the festivity that was at their wedding,	And of the feste that was at hir weddynge,
I leave this noble duke riding to Athens,	Lete I this noble duc to Atthenes ryde,
That there was no one greater under the sun.	That gretter was ther noon under the sonne.
He is his slave to whom he has said	He is his thral to whom that he hath sayd
Act as if thou were deaf, if thou hear	Dissimule as thou were deef, if that thou heere
Comes much harm; thus was me told and taught.	Comth muchel harm; thus was me toold and taught.
But for little speech well considered	But for litel speche avysely
But nonetheless, thus taught me my mother:	But nathelees, thus taughte me my dame:
Unto the devil, to whom I commit him;	Unto the devel, which I hym bitake;
Nor never in all thy life shalt thou speak.	Ne nevere in al thy lif ne shaltou speke.
Before you act in any way	Er ye doon any execucion
Full guiltless, that dare I swear, indeed!	Ful giltelees, that dorste I swere, ywys!
For sorrow of which he broke his musical instruments,	For sorwe of which he brak his mynstralcie,
What more do you want? The crow immediately him told,	What wol ye moore? The crowe anon hym tolde,
To hear thy voice? Alas, what song is this?"	To heere thy voys? Allas, what song is this?"
I will go to my tale, as I began.	I wol go to my tale, as I bigan.
That, because the tyrant is of greater might	That, for the tirant is of gretter myght
Except that the gentle, higher in rank,	But that the gentile, in estaat above,
The wise Plato says, as you may read,	The wise Plato seith, as ye may rede,
Deceived was, despite all his attractive qualities.	Deceyved was, for al his jolitee.
All these examples I about speak these men	Alle thise ensamples speke I by thise men
And let him see a mouse go by the wall,	And lat hym seen a mous go by the wal,
And keep it as cleanly as thou can,	And keep it al so clenly as thou may,
To please her, supposing for such pleasing actions,	To plesen hire, wenynge for swich plesaunce,
But all in vain, for it does not help.	But al in ydel, for it availleth noght.
Could not, by a hundred thousand times,	Ne koude, by an hondred thousand deel,
For his amusement, in sign also of victory	For his desport, in signe eek of victorie
Who with his singing walled that city,	That with his syngyng walled that citee,
He was the most lusty bachelor	He was the mooste lusty bachiler
To accord and love, and appease many a wrong.	T' acord and love, and many a wrong apese.
Of this vessel the Cook drank fast, alas!	Of this vessel the Cook drank faste, allas!
Yet I would rather pay for the mare	Yet hadde I levere payen for the mare
Tell on thy tale; of him I take no account.	Telle on thy tale; of hym make I no fors.
Upon this man, by my salvation,	Upon this man, by my savacioun,
For lack of speech, and down the horse him threw,	For lakke of speche, and doun the hors hym caste,
The devil of hell set his foot therein!	The devel of helle sette his foot therin!
And (providing) that our Host would (agree), of his courtesy,	And that oure Hoost wole, of his curteisye,
Or hast thou with some prostitute all night labored,	Or hastow with som quene al nyght yswonke,
A thief might full easily rob and bind him.	A theef myghte hym ful lightly robbe and bynde.
Nor legal cases, nor elaborate terms of law.	Ne phislyas, ne termes queinte of lawe.
Said the Shipman, "Here shall he not preach;	Seyde the Shipman, "Heer schal he nat preche;
Know much that is good, by God's dignity!"	Can moche good, by Goddes dignitee!"
Now Jesus Christ, that of his might may send	Now Jhesu Crist, that of his myght may sende
And finds her friends whole and sound;	And fyndeth hire freendes hoole and sounde;
That little while in joy or in pleasure	That litel while in joye or in plesance
To England are they come by the direct route,	To Engelond been they come the righte way,
A thousand fold well more (blissful) than I can tell.	A thousand foold wel moore than I kan telle.
Was put alone and damned to die.	Was put allone and dampned for to dye.
The morning came, and Alla began to prepare himself,	The morwe cam, and Alla gan hym dresse,
As he that is of Christian folk the flower,	As he that is of Cristen folk the flour,
In relief of her long, pitiful pain,	In relief of hir longe, pitous pyne,
I can not tell their woe until to-morrow,	I may nat telle hir wo until to-morwe,
"Now God," said he, "and his saints bright	"Now God," quod he, "and his halwes brighte
Hardly upon her feet she could stand.	Unnethe upon hir feet she myghte stonde.
And afterward he made his contrary argument:	And afterward he made his argument:
Now was this child as like unto Custance	Now was this child as lyk unto Custance
A mother he has, but father has he none	A mooder he hath, but fader hath he noon
This senator has led this child to the feast;	This senatour hath lad this child to feeste;
As well to show his high magnificence	As wel to shewen his heighe magnificence
That, if I shortly tell shall and plainly,	That, if I shortly tellen shal and playn,
In holy works ever, as was her special gift of God.	In hooly werkes evere, as was hir grace.
In which Custance sits full piteously.	In which Custance sit ful pitously.
For which this Emperor has sent at once	For which this Emperour hath sent anon
Until Christ's mother -- blessed be she always! --	Til Cristes mooder -- blessed be she ay! --
To slay that Holofernes in his tent,	To sleen hym Olofernus in his tente,
That not for the deed sometimes, but for the intention	That noght for werk somtyme, but for th' entente
But blissful Mary helped her right then;	But blisful Marie heelp hire right anon;
On the point of dying, as I shall tell you soon.	In point to spille, as I shal telle yow soone.
But now will I go unto Custance,	But now wol I unto Custance go,
The hand was known that the letter wrote,	The hand was knowe that the lettre wroot,
And plainly the whole affair he him told	And pleynly al the manere he hym tolde
Abundantly for her very long time (of sailing),	Habundantly for hire ful longe space,
And if thou dare not save him, for fear of punishment,	And if thou darst nat saven hym, for blame,
Now, lady bright, to whom all woeful (people) cry,	Now, lady bright, to whom alle woful cryen,
And into heaven her eyes up she caste.	And into hevene hire eyen up she caste.
In the salt sea, although I see not how.	In salte see, althogh I se noght how.
Weep both young and old in all that place	Wepen bothe yonge and olde in al that place
Full often he said, "Alas and woe!"	Ful ofte he seyde, "Allas and weylaway!"
Her, and her young son, and all her gear,	Hire, and hir yonge sone, and al hir geere,
He sleeps, and he snorts in his way	He slepeth, and he fnorteth in his gyse
And therefore to the fiend I thee consign;	And therfore to the feend I thee resigne;
And forth he goes; there is nothing more to do.	And forth he gooth; ther is na moore to doone.
"Welcome be the dispensation of Christ for evermore	"Welcome the sonde of Crist for everemoore
The letter said the queen delivered was	The lettre spak the queene delivered was
Donegild answered, "Right now, at this time, no;	Donegild answerde, "As now at this tyme, nay;
Unto the king's mother rides quickly,	Unto the kynges mooder rideth swithe,
So long is gone with child, until that quietly	So longe is goon with childe, til that stille
They must take in patience at night	They moste take in pacience at nyght
So foreign a creature as his mate.	So strange a creature unto his make.
And after this Jesus, of His mercy,	And after this Jhesus, of his mercy,
Great was the fear and also the repentance	Greet was the drede and eek the repentance
That down he fell at once like a stone,	That doun he fil atones as a stoon,
Since a noble heart is filled with pity,	As gentil herte is fulfild of pitee,
Amongst all the faces in that route?	Amonges alle the faces in that route?
From false blame, and thou, merciful maid,	Fro false blame, and thou, merciful mayde,
Deeper in this, to learn the truth.	Depper in this, a trouthe for to lere.
Falsely testifies that she has done this thing.	Berth hire on hond that she hath doon thys thyng.
To king Alla was told all this misfortune,	To kyng Alla was toold al this meschance,
And cut the throat of Hermengild in two,	And kitte the throte of Hermengyld atwo,
She would do no sin, in no way.	She wolde do no synne, by no weye.
Against the Scots, as men may well hear;	Agayn the Scottes, as men may wel heere;
Custance answered, "Sir, it is Christ's might,	Custance answerde, "Sire, it is Cristes myght,
Bent over and old, with eyes fast shut.	Croked and oold, with eyen faste yshette.
And near the castle there dwelt three such (Christians).	And ny the castel swiche ther dwelten three.
In all that land no Christians dared assemble;	In al that lond no Cristen dorste route;
She was so diligent, without laziness,	She was so diligent, withouten slouthe,
But nonetheless by means of this she was understood.	But algates therby was she understonde.
That thence it would not (move) for the duration of an entire tide;	That thennes wolde it noght of al a tyde;
Who fed the Egyptian Mary in the cave,	Who fedde the Egipcien Marie in the cave,
With dry feet through the sea passing.	With drye feet thurghout the see passynge.
By certain means often, as know clerks,	By certeine meenes ofte, as knowen clerkis,
Men might ask why she was not slain	Men myghten asken why she was nat slayn
Banisher of fiends out of man and woman	Flemere of feendes out of hym and here
Unto the cross of Christ thus said she:	Unto the croys of Crist thus seyde she:
They have set her, and told her to learn to sail	They han hir set, and bidde hire lerne saille
Are all hacked to pieces and stabbed at the table,	Been al tohewe and stiked at the bord,
But all too dear they paid for it before they rise (from the feast).	But al to deere they boghte it er they ryse.
And thus in mirth and joy I let them remain;	And thus in murthe and joye I lete hem dwelle;
I do not believe the triumph of Julius,	Noght trowe I the triumphe of Julius,
And said his wife was come, without doubt,	And seyde his wyf was comen, out of doute,
That she might have the Christian folk to feast --	That she moste han the Cristen folk to feeste --
Thy instrument thus -- alas the times! --	Thyn instrument so -- weylawey the while! --
O serpent under (cover of) femininity,	O serpent under femynynytee,
And to them all she spoke right in this manner:	And to hem alle she spak right in this wyse:
Because we renounced our faith in Mohammed?	For we reneyed Mahoun oure creance?
"Lords," said she, "you know each one of you,	"Lordes," quod she, "ye knowen everichon,
She takes pains to make a cheerful appearance;	She peyneth hire to make good contenance;
Was there no astrologer in all thy town?	Was ther no philosophre in al thy toun?
At the beginning of this dangerous voyage,	At the bigynnyng of this fiers viage,
Nor at Rome, for the harm wrought by Hannibal	N' at Rome, for the harm thurgh Hanybal
Nor shall I never see you again with my eyes.	Ne shal I nevere seen yow moore with ye.
And to be bound under subjection	And to be bounden under subjeccioun
The day is come of her departure;	The day is comen of hir departynge;
Well may men know that such great preparation	Wel may men knowen that so greet ordinance
And all his vassals should christened be,	And alle his liges sholde ycristned be,
To get her who has my life in her keeping,	To geten hire that hath my lyf in cure,
Because there was such difference	By cause that ther was swich diversitee
To arrange some remedy to save his life .	To shapen for his lyf som remedye.
The strife of Thebes; and of Hercules,	The strif of Thebes; and of Ercules,
Perhaps in that large book	Paraventure in thilke large book
Entertain them well, and busily seek out	Make hem good chiere, and bisily espye
But now to the point let us turn again.	But now to purpos lat us turne agayn.
I pray to God to sustain her in honor,	I prey to God in honour hire susteene,
And it so happened that the excellent renown	And so bifel that th' excellent renoun
With them, and also to sell them their goods.	With hem, and eek to sellen hem hire ware.
I would right now be without any tales,	I were right now of tales desolaat,
And all thy friends flee from thee, alas!	And alle thy freendes fleen from thee, allas!
When his tail shall burn in the live coals,	Whan that his tayl shal brennen in the gleede,
To ask help thou art ashamed in thy heart;	To asken help thee shameth in thyn herte;
To the Muses that men call Pierides --	To Muses that men clepe Pierides --
How that the cursed king Antiochus	How that the cursed kyng Antiochus
The cruelty of thee, queen Medea,	The crueltee of the, queene Medea,
There may he see the large wounds wide	Ther may he seen the large woundes wyde
In one book, he has said them in another.	In o book, he hath seyd hem in another.
All my promise, I can say no better.	Al my biheste, I kan no bettre sayn.
Let us not grow moldy thus in idleness.	Lat us nat mowlen thus in ydelnesse.
And in part through negligence when we are awake,	And what thurgh necligence in oure wakynge,
Five and forty degrees had climbed on height,	Degrees was fyve and fourty clombe on highte,
The arc of his twelve-hour day has run	The ark of his artificial day hath ronne
For if I should reckon every vice	For and I sholde rekenen every vice
Are they, us innocent men to deceive,	Been they, us sely men for to deceyve,
He kisses her and embraces her full often,	He kisseth hire and clippeth hire ful ofte,
First when his sight is newly come again,	First whan his sighte is newe come ageyn,
But, by my father's soul, I thought to have seen	But, by my fader soule, I wende han seyn
You have some glimpse, and no perfect sight."	Ye han som glymsyng, and no parfit sighte."
Was no thing better, to make you to see,	Was no thyng bet, to make yow to see,
Unless I would speak crudely;	But if I wolde speke uncurteisly;
Pulled up the smock, and in he thrust.	Gan pullen up the smok, and in he throng.
For well I know that you mistrust me,	For wel I woot that ye mystruste me,
To eat some of the small green pears.	To eten of the smale peres grene.
"You love I best, and shall, and none other."	"Yow love I best, and shal, and oother noon."
That I would grant him his sight again,	That I wolde graunten hym his sighte ageyn,
I reckon all the villainy	I sette right noght, of al the vileynye
Why though he made a temple, God's house?	What though he made a temple, Goddes hous?
With martyrdom they proved their constancy.	With martirdom they preved hire constance.
Yet shall we women face it out boldly,	Yit shul we wommen visage it hardily,
In reproof of both her and many others."	Bothe in repreve of hire and othere mo."
Fall upon your bodies yet to-night!	So falle upon youre bodyes yet to-nyght!
Filled with wisdom and with worldly glory,	Fulfild of sapience and of worldly glorie,
How in his grisly chariot he fetched her --	How in his grisely carte he hire fette --
But little from his declination	But litel fro his declynacion
And every sign that she could make,	And every signe that she koude make,
Why speak you thus? But men are always untrue,	Why speke ye thus? But men been evere untrewe,
Wherefore I will answer in this manner,	Wherfore I wole answere in this manere,
For true love; this is without doubt.	For verray love; this is withouten doute.
I give it to you, draw up deeds as you please;	I yeve it yow, maketh chartres as yow leste;
I had rather die on a knife	Levere ich hadde to dyen on a knyf
And in he hurried, and that in such a way	And in he stirte, and that in swich manere
The garden is enclosed all about;	The gardyn is enclosed al aboute;
Were passed [of] the month of [June], it happened	Were passed [of] the month of [Juyn], bifil
Some wonder by this latchkey shall betide,	Som wonder by this clyket shal bityde,
Yet was he deceived, and, God knows, so are others	Yet was he blent, and, God woot, so been mo
Who had a hand upon her always.	That hadde an hand upon hire everemo.
Who loves Damian so graciously	That loveth Damyan so benyngnely
For when he knew it can not be otherwise,	For whan he wiste it may noon oother be,
And with all this the fire of jealousy,	And therwithal the fyr of jalousie,
Thy gifts under appearance of steadfastness,	Thy yiftes under hewe of stidefastnesse,
And in this way, many a merry day,	And in this wyse, many a murye day,
Such pleasure has in it to walk and play,	Swich deyntee hath in it to walke and pleye,
Could not the beauty of it well describe;	Ne koude of it the beautee wel devyse;
This noble January, with all his might,	This noble Januarie, with al his myght,
And also to January he goes as humbly	And eek to Januarie he gooth as lowe
And craftily this letter down she thrust	And sotilly this lettre doun she threste
And rejoice in her cruel pride,	And hem rejoysen in hire crueel pryde,
I care not, for here I him assure	I rekke noght, for heere I hym assure
To any woman to get her love,	To any womman for to gete hire love,
How he worked, I dare not tell to you,	How that he wroghte, I dar nat to yow telle,
She tore it all to pieces at the last,	She rente it al to cloutes atte laste,
For I am dead if this thing be known."	For I am deed if that this thyng be kyd."
With all her women unto Damian.	With alle hir wommen unto Damyan.
That all you go see this Damian.	That alle ye go se this Damyan.
But after dinner, as soon as ever I can,	But after mete, as soone as evere I may,
Excused him because of his sickness,	Excused hym by cause of his siknesse,
The fourth day completed from noon to noon,	The fourthe day compleet fro noon to noon,
And in a purse of silk which hung on his shirt	And in a purs of sylk heng on his sherte
Also if thou speak, she will thy woe reveal.	Eek if thou speke, she wol thy wo biwreye.
Or else long can he not endure;	Or elles longe may he nat endure;
In his night-cap, and with his lean neck;	In his nyght-cappe, and with his nekke lene;
And then he takes a bit of bread soaked in fine claret,	And thanne he taketh a sop in fyn clarree,
That can work both well and hastily;	That may bothe werke wel and hastily;
He lulls her; he kisses her full often;	He lulleth hire; he kisseth hire ful ofte;
And to his private friends thus said he:	And to his privee freendes thus seyde he:
Where they attend to their affairs as they pleased	Where as they doon hir thynges as hem leste,
For in this world is no worse pestilence	For in this world nys worse pestilence
O perilous fire, that in the bedstraw breeds!	O perilous fyr, that in the bedstraw bredeth!
Who carved before the knight full many a day.	Which carf biforn the knyght ful many a day.
And that the night would last evermore.	And that the nyght wolde lasten everemo.
That he that night in arms would her strain	That he that nyght in armes wolde hire streyne
Her to behold it seemed an enchantment.	Hire to biholde it semed fayerye.
Who writes for us that same wedding merry	That writest us that ilke weddyng murie
And Venus laughs upon every person,	And Venus laugheth upon every wight,
And full of instruments and of foods,	And ful of instrumentz and of vitaille,
Forth comes the priest, with stole about his neck,	Forth comth the preest, with stole aboute his nekke,
That she, this maiden who May was called,	That she, this mayden which that Mayus highte,
Be not afraid of this, my brother dear,	Beth nat agast herof, my brother deere,
Swifter than does an arrow out of a bow.	Swifter than dooth an arwe out of a bowe.
You may repent of the wedded man's life,	Ye may repente of wedded mannes lyf,
This is my dread, and you, my brethren two,	This is my drede, and ye, my bretheren tweye,
And such great ease and pleasure in marriage	And so greet ese and lust in mariage
For then, he said, his spirit was at ease.	For thanne, he seyde, his spirit was at ese.
He said there was a maiden in the town,	He seyde ther was a mayden in the toun,
That hastily they would come to him;	That hastily they wolden to hym come;
Her wise self-control, her nobility,	Hir wise governaunce, hir gentillesse,
And some were rich and had a bad reputation.	And somme were riche and hadden badde name.
And set it in a common market-place,	And sette it in a commune market-place,
"That hinders matrimony, certainly."	"That letteth matrimoigne, sikerly."
This is to say, to do her full pleasure.	This is to seyn, to doon hire ful plesaunce.
But I know best where my shoe pinches me.	But I woot best where wryngeth me my sho.
And all this requires leisure to find out.	And al this axeth leyser for t' enquere.
Whether she be wise, or sober, or given to drink,	Wher she be wys, or sobre, or dronkelewe,
Seneca, amongst other words wise,	Senek, amonges othere wordes wyse,
And truly, it is a bold act	And trewely, it is an heigh corage
That dares presume, or else think it,	That dar presume, or elles thenken it,
And God it knows, though I am unworthy,	And God it woot, though I unworthy be,
To deviate from the word of Solomon.	To weyven fro the word of Salomon.
As every day altercation occurs	As al day falleth altercacioun
And a blossom-filled tree is neither dry nor dead.	And blosmy tree nys neither drye ne deed.
Or so that each of them should help the other	Or for that ech of hem sholde helpen oother
There speaks many a man of marriage	Ther speketh many a man of mariage
For if it so were that I had such bad luck	For if so were I hadde swich myschaunce
And also these old widows, God it knows,	And eek thise olde wydwes, God it woot,
You shall rather such a thing discover	Ye shullen rather swich a thyng espyen
I have my body foolishly wasted;	I have my body folily despended;
For which this January, of whom I told,	For which this Januarie, of whom I tolde,
I warn thee, if wisely thou wilt act,	I warne thee, if wisely thou wolt wirche,
The people of God, and made that same Mordecai	The peple of God, and made hym Mardochee
By good counsel of his mother Rebecca,	By good conseil of his mooder Rebekke,
Or else pray to God to send him	Or elles preye to God hym for to sende
She keeps his goods, and wastes not a bit;	She kepeth his good, and wasteth never a deel;
So obedient and so virtuous is she,	So buxom and so vertuous is she,
And hearken why -- I say not this for nothing --	And herke why -- I sey nat this for noght --
Such as lands, rents, pasture, or right to use common land,	As londes, rentes, pasture, or commune,
Will take care of thee better than she that waits always	Wol kepe thee bet than she that waiteth ay
And yet some clerks say it is not so,	And yet somme clerkes seyn it nys nat so,
Whereas a wedded man in his estate	Ther as a wedded man in his estaat
And lead his life in joy and in pleasure,	And lede his lyf in joye and in solas,
"No other life," said he, "is worth a bean,	"Noon oother lyf," seyde he, "is worth a bene,
Were it for holiness or for dotage	Were it for hoolynesse or for dotage
For sorry heart, I can tell no more."	For soory herte, I telle may namoore."
These two months, and no more, by God;	Thise monthes two, and moore nat, pardee;
Between Griselda's great patience	Bitwix Grisildis grete pacience
I know enough, on evenings and mornings,"	I knowe ynogh, on even and a-morwe,"
They said, "The man is crazy, my dear brother";	They seyde, "The man is wood, my leeve brother";
And that he begged them, for God's love,	And that he preyed hem, for Goddes love,
Who yet lay in a swoon, both pale and wan,	That yet aswowne lay, bothe pale and wan,
And thought, "Alas, now comes Nowell's flood!"	And thoughte, "Allas, now comth Nowelis flood!"
So that with the stroke he was almost blinded;	That with the strook he was almoost yblent;
This Nicholas was risen to piss,	This Nicholas was risen for to pisse,
He coughs first, and knocks then	He cogheth first, and knokketh therwithal
And I will bring it back to thee very soon."	And I wol brynge it thee agayn ful soone."
Why rise you so early? Ay, bless me!	Why rise ye so rathe? Ey, benedicitee!
Very often he did renounce love-making,	Ful ofte paramours he gan deffie,
With dust, with sand, with straw, with cloth, with chips,	With dust, with sond, with straw, with clooth, with chippes,
He felt a thing all rough and long haired,	He felte a thyng al rough and long yherd,
"Get done with it," said she, "come on, and hurry up,	"Have do," quod she, "com of, and speed the faste,
"Wilt thou then go thy way with that?" said she.	"Wiltow thanne go thy wey therwith?" quod she.
"Go from the window, you idiot," she said;	"Go fro the wyndow, Jakke fool," she sayde;
"What do you, honey-comb, sweet Alisoun,	"What do ye, hony-comb, sweete Alisoun,
Up rises this elegant lover Absolon,	Up rist this joly lovere Absolon,
To Alison now I will tell all	To Alison now wol I tellen al
And dwell at the granary a day or two;	And dwellen at the grange a day or two;
That is for love always so woebegone,	That is for love alwey so wo bigon,
Down on the ladder stalks Nicholay,	Doun of the laddre stalketh Nicholay,
"Now, Pater-noster, quiet!" said Nicholay,	"Now, Pater-noster, clom!" seyde Nicholay,
With bread, and cheese, and good ale in a jug,	With breed, and chese, and good ale in a jubbe,
He weeps, wails, looks wretched;	He wepeth, weyleth, maketh sory cheere;
Help us to escape, or we are dead each one of us!	Help us to scape, or we been dede echon!
Men say thus, `send the wise, and say nothing.'	Men seyn thus, `sende the wise, and sey no thyng.'
For it is God's own dear command.	For it is Goddes owene heeste deere.
Be merry, for the flood will soon pass.'	Be myrie, for the flood wol passe anon.'
And hast laid our victuals carefully in them,	And hast oure vitaille faire in hem yleyd,
I will not tell God's secrets.	I wol nat tellen Goddes pryvetee.
A kneading trough, or else a large vat,	A knedyng trogh, or ellis a kymelyn,
"Hast thou not heard," said Nicholas, "also	"Hastou nat herd," quod Nicholas, "also
Thou mayst not act according to thine own ideas;	Thou mayst nat werken after thyn owene heed;
That Noah's flood was never half so large.	That half so greet was nevere Noes flood.
"Nay, Christ forbid it, for his holy blood!"	"Nay, Crist forbede it, for his hooly blood!"
And when each of them had drunk his part,	And whan that ech of hem had dronke his part,
Began to sigh deeply, and said, "Alas!	Gan for to sik soore, and seyde, "Allas!
Awake, and think on Christ's passion!	Awak, and thenk on Cristes passioun!
And to the chamber door he turned his attention.	And to the chambre dore he gan hym dresse.
He walked in the fields to look	He walked in the feeldes for to prye
This carpenter began to bless himself,	This carpenter to blessen hym bigan,
How can you sleep all the long day?"	How may ye slepen al the longe day?"
This world is now very ticklish, surely.	This world is now ful tikel, sikerly.
He would not answer for anything that might befall.	He nolde answere for thyng that myghte falle.
And right away, without more words,	And right anon, withouten wordes mo,
For Absolon may wail and sing "alas."	For Absolon may waille and synge "allas."
He had for his labor nothing but scorn.	He ne hadde for his labour but a scorn.
He sent her sweetened wine, mead, and spiced ale,	He sente hire pyment, meeth, and spiced ale,
And she answered her husband immediately,	And she answerde hir housbonde therwithal,
And took his place up by a casement window	And dressed hym up by a shot-wyndowe
This parish clerk, this elegant Absolon,	This parissh clerk, this joly Absolon,
About farting, and fastidious in his speech.	Of fartyng, and of speche daungerous.
In twenty different ways could he trip and dance	In twenty manere koude he trippe and daunce
With St. Paul's window carved on his shoes,	With Poules wyndow corven on his shoos,
Christ's own works to do,	Cristes owene werkes for to wirche,
"No, care thee not about that," said Nicholas.	"Nay, therof care thee noght," quod Nicholas.
This Nicholas began to cry for mercy,	This Nicholas gan mercy for to crye,
For secret love of thee, sweetheart, I die."	For deerne love of thee, lemman, I spille."
She was a primrose, a pig's eye (a flower),	She was a prymerole, a piggesnye,
As any swallow sitting on a barn.	As any swalwe sittynge on a berne.
Than is the new early-ripe pear tree,	Than is the newe pere-jonette tree,
White was her smock, and embroidered all in front	Whit was hir smok, and broyden al bifoore
Who advised that man should wed his equal.	That bad man sholde wedde his simylitude.
Very often his merry throat was blessed.	Ful often blessed was his myrie throte.
His Almagest, and books large and small,	His Almageste, and bookes grete and smale,
Concerning every thing; I can not reckon them all.	Of every thyng; I may nat rekene hem alle.
A rich churl, who took in boarders,	A riche gnof, that gestes heeld to bord,
Of historical matter that concerns nobility,	Of storial thyng that toucheth gentillesse,
But told his churl's tale in his manner.	But tolde his cherles tale in his manere.
Yet I would not, for the oxen in my plow,	Yet nolde I, for the oxen in my plogh,
Thou canst say enough about other things."	Thou mayst ynogh of othere thynges seyn."
And therefore if that I misspeak or say (amiss),	And therfore if that I mysspeke or seye,
And said, "Wait, Robin, my dear brother;	And seyde, "Abyd, Robyn, my leeve brother;
Something to equal the Knight's tale."	Somwhat to quite with the Knyghtes tale."
When the Knight had thus told his tale,	Whan that the Knyght had thus his tale ytoold,
His daughter, who was called Phanye.	His doghter, which that called was Phanye.
Whom he knew to abound in good judgment,	Which that he knew in heigh sentence habounde,
Such luck that he escaped by means of the rain,	Swich hap that he escaped thurgh the rayn,
Of which Croesus Cyrus was sorely afraid,	Of which Cresus Cirus soore hym dradde,
Lucan, to thee this history I commend,	Lucan, to thee this storie I recomende,
But never groaned he at no stroke but one,	But nevere gronte he at no strook but oon,
Full secretly has made conspiracy	Ful prively hath maad conspiracye
Of Rome, who fled at this battle.	Of Rome, which that fleigh at this bataille.
O mighty Caesar, that in Thessaly	O myghty Cesar, that in Thessalie
The which two for all this woe I blame?	The whiche two of al this wo I wyte?
Thou were poisoned by thine own folk;	Empoysoned of thyn owene folk thou weere;
Whom he conquered, and brought them into woe?	Whiche he conquered, and broghte hem into wo?
Between him and another conqueror;	Bitwixe hym and another conquerour;
[Concerning Alexander]	De Alexandro
In this affliction he wailed and also wept,	In this meschief he wayled and eek wepte,
That it tore to pieces his limbs and his skin,	That it his limes and his skyn totar,
That in his guts it carved so and bit	That in his guttes carf it so and boot
And because Nicanor and Timotheus	And for that Nichanore and Thymothee
And why he fell from high prosperity,	And why he fil fro heigh prosperitee,
Sleeping, smote off his head, and from his tent	Slepynge, his heed of smoot, and from his tente
"Nebuchadnezzar was god," said he;	"Nabugodonosor was god," seyde hee;
That put more reigns in subjection,	That regnes mo putte in subjeccioun,
And in this garden found he two churls	And in this gardyn foond he cherles tweye
Then he knew well, he had himself deluded,	Tho wiste he wel, he hadde himself mysgyed,
To set a man that is filled full of vice	To sette a man that is fulfild of vice
Which afterward seemed to him a greet grievance;	Which afterward hym thoughte a greet grevaunce;
This Seneca, of whom I tell,	This Seneca, of which that I devyse,
When might is joined unto cruelty,	Whan myght is joyned unto crueltee,
His mother he put in piteous situation,	His mooder made he in pitous array,
That same clothing that he had worn one day,	That ilke clooth that he hadde wered o day,
Although Nero was as vicious	Although that Nero were as vicius
They leyde hem in his lappe adoun and deyde.	And after that, within a day or two,
For wo his armes two he gan to byte,	And when the woeful father saw him dead,
Is ther no morsel breed that ye do kepe?	When will the jailer bring our soup?
Whan that his mete wont was to be broght,	And on a day befell that in that hour
Swiche briddes for to putte in swich a cage!	Alas, Fortune, it was great cruelty
Withinne his prisoun made thee to dye --	For he was thy nephew and son-in-law,
They in thy bed han slayn thee by the morwe.	And for no thing but for thy chivalry
Noght Charles Olyver, that took ay heede	The wicked nest was worker of this violent act.
Wel oghten men thy pitous deeth complayne!	Whom Fortune held so high in majesty,
Dredeful to kynges and to emperoures,	Alas, Fortune! She that formerly was
And wan the land, and hoom to Rome he wente.	And put her in fetters, and also her two children,
This myghty queene may no while endure.	But always Fortune has bitterness in her honey;
Ne noon Ermyn, ne noon Egipcien,	Dared never be so courageous
The regnes heeld, and with hire propre hond	When Odenake was dead, she mightily
Ay whil that Odenakes dayes laste.	Nor never could their foemen make them flee,
Whan that she leyser hadde; and for to entende	To have of various tongues full knowing,
I seye, so worshipful a creature,	But now unto our tale we turn.
Namoore sholde he pleyen thilke game	And if she were with childe at that time,
For ech of hem hadde oother lief and deere,	They lived in joy and in felicity,
Ther myghte no thyng in hir armes stonde.	With any young man, were he never so strong.
With arwes brode that she to hem sente.	And many a wild hart's blood she shed
As writen Persiens of hir noblesse,	Zenobia, of Palmyra queen,
Lordynges, ensample heerby may ye take	Though for this he had neither right nor law.
And heryest false goddes cursedly;	Drank of the same vessels various wines;
That God of hevene hath domynacioun	Until he knew, by grace and by reason,
But Daniel expowned it anoon,	Who could explain what this text meant;
Hys wyf, his lordes, and his concubynes	For the honor that our elders left with us."
But Fortune caste hym doun, and ther he lay,	His high estate made him confident in pride;
Was he to doon amys or moore trespace;	He thanked God, and always in his life in fear
But sodeynly he loste his dignytee,	Could not deprive him of his estate.
Sixty cubites long and sevene in brede,	This proud king had made a statue of gold,
In which his glorie and his delit he hadde.	At Babylon was his sovereign throne,
Thanne wayteth she her man to overthrowe	Be wary, for when Fortune wants to deceive,
Til that his flessh was for the venym blaked.	But on his back all naked he wore this shirt
And as thise clerkes maken mencioun,	Who was called Dianira, fresh as May;
Was nevere wight, sith that this world bigan,	And long bore the heaven on his neck.
He golden apples rafte of the dragoun;	He slew the Harpies, the fierce cruel birds;
Beware by this example old and plain	Beth war by this ensample oold and playn
And made him as their fool play before them;	And made hym as hire fool biforn hem pleye;
But before his hair was clipped or shaven,	But er his heer were clipped or yshave,
But soon shall he weep many a tear,	But soone shal he wepe many a teere,
High on a hill where men could see them.	Hye on an hill whereas men myghte hem see.
That God would on his pain have some pity	That God wolde on his peyne han some pitee
Three hundred foxes Sampson took for ire,	Thre hundred foxes took Sampson for ire,
But to his wives he told his secret,	But to his wyves toolde he his secree,
Had never worldly man so high degree	Hadde nevere worldly man so heigh degree
For though Fortune may harm no angel,	For though Fortune may noon angel dere,
I will bewail in the manner of tragedy	I wol biwaille in manere of tragedie
Lo, this explanation ought to suffice enough.	Lo, this declaryng oghte ynogh suffise.
Of which I have a hundred in my cell.	Of whiche I have an hundred in my celle.
God knows, you pay with no inferior coins!	God woot, no lussheburghes payen ye!
Though he had a tonsure very prominently upon his head,	Though he were shorn ful hye upon his pan,
A very handsome person indeed.	A wel farynge persone for the nones.
I vow to God, thou hast a very handsome complexion;	I vowe to God, thou hast a ful fair skyn;
That shall he find that does or says something amiss to her --	That shal he fynde that hire mysdooth or seith --
Thou darest not defend thy wife's right!'	Thou darst nat stonden by thy wyves right!'
Will not in church bow to my wife,	Wol nat in chirche to my wyf enclyne,
And by that precious body of Madrian,	And by that precious corpus Madrian,
Sir Pardoner, be glad and merry of cheer;	Sire Pardoner, be glad and myrie of cheere;
Instead of relics or a container for relics.	In stide of relikes or of seintuarie.
Come forth, sir Host, and offer first right now,	Com forth, sire Hoost, and offre first anon,
To absolve you in the countryside as you ride,	T' assoille yow in contree as ye ryde,
If any of you will, of devotion,	If any of yow wole, of devocion,
I absolve you, by my high power,	I yow assoille, by myn heigh power,
Thou art so false and so unnatural, alas?	Thou art so fals and so unkynde, allas?
Thus ended are these two homicides,	Thus ended been thise homycides two,
"Now let us sit and drink, and make us merry,	"Now lat us sitte and drynke, and make us merie,
The third he kept clean for his drink.	The thridde he kepte clene for his drynke.
Only so much as the amount of a seed of wheat,	Noght but the montance of a corn of whete,
And prayed him that he would sell him	And preyde hym that he hym wolde selle
Of God that should live so merrily as I!"	Of God that sholde lyve so murye as I!"
Then we both can fulfill all our desires,	Thanne may we bothe oure lustes all fulfille,
That, by my troth, I will not betray thee."	That, by my trouthe, I wol thee nat biwreye."
But nevertheless, if I can arrange things so	But nathelees, if I kan shape it so
And commanded them to draw and see where it will fall;	And bad hem drawe and looke where it wol falle;
Wherefore I advise that among us all straws	Wherfore I rede that cut among us alle
To-day that we should have such good fortune?	To-day that we sholde han so fair a grace?
But each of them was so glad of that sight,	But ech of hem so glad was of that sighte,
Under a tree, and there he will wait;	Under a tree, and there he wole abyde;
Thou spoke right now of that same traitor Death.	Thou spak right now of thilke traytour Deeth.
`In the presence of an old man, gray upon his head,	`Agayns an oold man, hoor upon his heed,
Alas, when shall my bones be at rest?	Allas, whan shul my bones been at reste?
Neither in city nor in any village,	Neither in citee ne in no village,
An old and poor man met with them.	An oold man and a povre with hem mette.
To live and die each of them for other,	To lyve and dyen ech of hem for oother,
"Is it such peril to meet with him?	"Is it swich peril with hym for to meete?
Always be ready to meet him;	Beth redy for to meete hym everemoore;
And suddenly he was slain last night,	And sodeynly he was yslayn to-nyght,
Had set themselves in a tavern to drink,	Were set hem in a taverne to drynke,
Seven is my number, and thine is five and three!"	Sevene is my chaunce, and thyn is cynk and treye!"
Lo, he forbids such swearing rather	Lo, rather he forbedeth swich sweryng
The high God forbad swearing at al,	The heighe God forbad sweryng at al,
Sent him a pair of dice of gold in scorn,	Sente him a paire of dees of gold in scorn,
To ally you unto any dice-players.	Yow for to allie unto none hasardours.
Stilboun, who was a wise ambassador,	Stilboun, that was a wys embassadour,
Blasphemy of Christ, manslaughter, and waste also	Blaspheme of Crist, manslaughtre, and wast also
And beyond all this, consider right well	And over al this, avyseth yow right wel
But listen, gentlemen, one word, I pray you,	But herkneth, lordynges, o word, I yow preye,
And namely from the white wine of Lepe	And namely fro the white wyn of Lepe
And through thy drunken nose the sound seems	And thurgh thy dronke nose semeth the soun
That may go through the gullet softly and sweetly.	That may go thurgh the golet softe and swoote.
Of which the end is death; belly is their god!"	Of whiche the ende is deeth; wombe is hir god!"
God shall destroy both," as Paul says.	Shal God destroyen bothe," as Paulus seith.
O, if a man knew how many evils	O, wiste a man how manye maladyes
Was bought that same cursed villainy!	Aboght was thilke cursed vileynye!
He says he can find no difference	He seith he kan no difference fynde
The Bible I take as my witness	The hooly writ take I to my witnesse
That it is grisly to hear them swear.	That it is grisly for to heere hem swere.
In Flanders once was a company	In Flaundres whilom was a compaignye
But listen, gentlemen, in conclusion:	But herkneth, lordynges, in conclusioun:
I will not do any labor with my hands,	I wol nat do no labour with myne handes,
Concerning this matter this ought to be enough.	Of this mateere it oghte ynogh suffise.
I preach of nothing but for greed.	I preche of no thyng but for coveityse.
In preaching, so that he shall not escape	In prechyng, so that he shal nat asterte
And not at all for correction of sin.	And nothyng for correccioun of synne.
And tell a hundred more false tales.	And telle an hundred false japes moore.
To offer to my relics in this place.	To offren to my relikes in this place.
He shall have multiplying of his grain,	He shal have multipliyng of his grayn,
As that same holy Jew taught our elders,	As thilke hooly Jew oure eldres taughte,
If cow, or calf, or sheep, or ox swell	If cow, or calf, or sheep, or oxe swelle
And in Latin I speak a few words,	And in Latyn I speke a wordes fewe,
'Greed is the root of all evil.'	Radix malorum est Cupiditas.
Tell us some moral thing, that we may learn	Telle us som moral thyng, that we may leere
Or else a draught of fresh and strong ale,	Or elles a draughte of moyste and corny ale,
And also thy vessels for analyzing urine and thy flasks,	And eek thyne urynals and thy jurdones,
That gifts of Fortune and of Nature	That yiftes of Fortune and of Nature
The Prologue ends.	Explicit prohemium.
And told our Host he should to him say	And bade oure Hoost he sholde to hym seye
"But nonetheless, this meditation	"But nathelees, this meditacioun
And therefore, if you wish -- I will not deceive you --	And therfore, if yow list -- I wol nat glose --
Why should I sow chaff out of my fist,	Why sholde I sowen draf out of my fest,
For every man, save thou, has told his tale.	For every man, save thou, hath toold his tale.
Said in this manner: "Gentlemen, every one,	Seyde in this wise: "Lordynges everichoon,
Four of the clock it was then, as I suppose,	Foure of the clokke it was tho, as I gesse,
For be he ignorant man, or else learned,	For be he lewed man, or ellis lered,
So prayed for him (Claudius) that he was exiled;	So preyde for hym that he was exiled;
The people immediately suspected in this matter,	The peple anon had suspect in this thyng,
And with that word down she fell in a swoon.	And with that word aswowne doun she fil.
Except that she ran first to see her father,	But for she ran hir fader first to see,
About his neck, as she was accustomed to do.	Aboute his nekke, as she was wont to do.
O gem of chastity, in patience	O gemme of chastitee, in pacience
"Daughter," said he, "Virginia, by thy name,	"Doghter," quod he, "Virginia, by thy name,
And when this worthy knight Virginius	And whan this worthy knyght Virginius
And would have proven it as a knight should (by battle),	And wolde have preeved it as sholde a knyght,
My servant, who is my slave by right,	My servant, which that is my thral by right,
Let him be called, and I will gladly hear (the case);	Lat do hym calle, and I wol gladly heere;
And gave his judgements upon various cases.	And yaf his doomes upon sondry cas.
Home goes the churl, who is called Claudius.	Hoom gooth the cherl, that highte Claudius.
Secretly, and made him swear	In secree wise, and made hym to ensure
For certainly, not by any force nor by any bribery,	For certes, by no force ne by no meede,
And it so happened that this judge cast his eyes	And so bifel this juge his eyen caste
So that throughout that land they praised her everyone	That thurgh that land they preised hire echone
Let one ensample sufficefor the present,	Suffiseth oon ensample now as heere,
You fathers and you mothers also as well,	Ye fadres and ye moodres eek also,
A thief of venison, who has abandoned	A theef of venysoun, that hath forlaft
Who have lords' daughters in governance,	That lordes doghtres han in governaunce,
Because she wanted to flee the company	For that she wolde fleen the compaignye
She spoke, and all her words, long speeches and brief,	She spak, and alle hire wordes, moore and lesse,
As well in spirit as in body chaste was she,	As wel in goost as body chast was she,
And a rose red, just so with such pigments	And reed a rose, right with swich peynture
Under the moon, which may grow less or grow larger,	Under the moone, that may wane and waxe,
When I wish; who can counterfeit my work?	Whan that me list; who kan me countrefete?
Filled with honor and with worthiness,	Fulfild of honour and of worthynesse,
And though I do not say the same words	And though I nat the same wordes seye
For some of them say more, and some say less,	For somme of hem seyn moore, and somme seyn lesse,
Or else, certainly, you are too hard to please.	Or elles, certes, ye been to daungerous.
"By God," said he, "for plainly, at one word,	"By God," quod he, "for pleynly, at a word,
"No more of this, for God's dignity,"	"Namoore of this, for Goddes dignitee,"
And because he was a knight errent,	And for he was a knyght auntrous,
Of Bevis of Hampton and sir Guy of Watwick,	Of Beves and sir Gy,
If you want to hear any more of it,	If ye wol any moore of it,
His bridle shone like the sun,	His brydel as the sonne shoon,
His shield was all of gold so red,	His sheeld was al of gold so reed,
A pair of trousers and also a shirt;	A breech and eek a sherte;
Of popes and of cardinals,	Of popes and of cardinales,
His merry men commanded he	His myrie men comanded he
Out of a terrible staff-sling.	Out of a fel staf-slynge.
When I have my armor;	Whan I have myn armoure;
A perilous man of deeds.	A perilous man of dede.
An elf-queen for to see,	An elf-queene for t' espye,
And sleep under my cloak.	And slepe under my goore.
For spurring on the soft grass,	For prikyng on the softe gras,
The male thrush made also her lay,	The thrustelcok made eek hir lay,
Happened a grievous misfortune.	Bitid a sory care.
In truth, as I can tell you,	For sothe, as I yow telle may,
Moreover he was a good archer;	Therto he was a good archeer;
He had a seemly nose.	He hadde a semely nose.
In Flanders, far beyond the sea,	In Flaundres, al biyonde the see,
"Yes, that is good," said he; "now we shall hear	"Ye, that is good," quod he; "now shul we heere
He in the waist is shaped as well as I;	He in the waast is shape as wel as I;
Said unto another, as you shall hear.	Seide unto another, as ye shuln heere.
For if thou have as much desire as thou hast might,	For if thou have corage as thou hast myght,
Is written for our instruction, indeed;	To oure doctrine it is ywrite, ywis;
All willfully, God let him never prosper!"	Al wilfully, God lat him nevere thee!"
When I seized you and brought you out of the yard.	Whan I yow hente and broghte out of the yerd.
Despite all you could do, the cock shall here remain.	Maugree youre heed, the cok shal heere abyde.
Now, good men, I pray you all to listen:	Now, goode men, I prey yow herkneth alle:
Out of the hive came the swarm of bees.	Out of the hyve cam the swarm of bees.
And also with staves many another man.	And eek with staves many another man.
Because their husbands lost all their lives --	For that hir husbondes losten alle hir lyves --
But supremely dame Pertelote shrieked	But sovereynly dame Pertelote shrighte
For on a Friday, truly, he was slain.	For on a Friday, soothly, slayn was he.
O Venus, who art goddess of pleasure,	O Venus, that art goddesse of plesaunce,
Stretching his neck, and held his eyes closed,	Strecchynge his nekke, and heeld his eyen cloos,
This Chauntecleer began to beat his wings,	This Chauntecleer his wynges gan to bete,
I have well read in `Dan Burnel the Ass,'	I have wel rad in `Daun Burnel the Asse,'
As did your father in the morning.	As dide youre fader in the morwenynge.
As has any angel that is in heaven.	As any aungel hath that is in hevene.
This Chauntecleer, when he did espy him,	This Chauntecleer, whan he gan hym espye,
How they sing well and merrily).	How that they syngen wel and myrily).
Pass over, for I said it as a joke.	Passe over, for I seyde it in my game.
My tale is of a cock, as you may hear,	My tale is of a cok, as ye may heere,
Or Boethius, or the Bishop Bradwardyn,	Or Boece, or the Bisshop Bradwardyn,
Thou were very well warned by thy dreams	Thou were ful wel ywarned by thy dremes
Until it had passed  a.m. of the day,	Til it was passed undren of the day,
As is the Book of Lancelot of the Lake,	As is the book of Launcelot de Lake,
And see the fresh flowers, how they spring;	And se the fresshe floures how they sprynge;
His seven wives walking by his side,	His sevene wyves walkynge by his syde,
He clucks when he has found a seed,	He chukketh whan he hath a corn yfounde,
And with that word he flew down from the beam,	And with that word he fley doun fro the beem,
It makes all my dread die;	It maketh al my drede for to dyen;
That I shall have of this vision	That I shal han of this avisioun
That day that Hector should lose his life,	That day that Ector sholde lese his lyf,
Warnings of things that shall afterward befall.	Warnynge of thynges that shul after falle.
"Dame Pertelote, I say you truly,	"Dame Pertelote, I sey yow trewely,
Of Mercia, how Kenelm dreamed a thing.	Of Mercenrike, how Kenelm mette a thyng.
And ship and man went under the water	And ship and man under the water wente
Men dream all the time of owls and of apes,	Men dreme alday of owles and of apes,
Thou shalt be drowned; my tale is at an end.'	Thow shalt be dreynt; my tale is at an ende.'
But on a day, toward the evening time,	But on a day, agayn the even-tyde,
And were hanged by the neck-bone.	And were anhanged by the nekke-bon.
Murder will out; we see that day by day.	Mordre wol out; that se we day by day.
And in this cart he lies gaping upright.	And in this carte he lith gapyng upright.
"This man began to fall in suspicion,	"This man gan fallen in suspecioun,
And told him in full detail how he was slain,	And tolde hym every point how he was slayn,
Thus twice in his sleeping he dreamed;	Thus twies in his slepyng dremed hee;
This man dreamed in his bed, where he lay,	This man mette in his bed, ther as he lay,
Therefore they must of necessity,	Wherfore they mosten of necessitee,
There need be no argument about this;	Ther nedeth make of this noon argument;
That has of wisdom such a great renown,	That hath of wysdom swich a greet renoun,
Of worms, before you take your laxatives	Of wormes, er ye take youre laxatyves
The which by nature have the power	The whiche han of hire propretee by kynde
"Now sir," said she, "when we fly from the beams,	"Now sire," quod she, "whan we flee fro the bemes,
Of strife, and of dogs, big and little;	Of contek, and of whelpes, grete and lyte;
Nothing, God knows, but foolishness is in dreams.	Nothyng, God woot, but vanitee in sweven is.
For certainly, whatever any woman says,	For certes, what so any womman seith,
His color was between yellow and red,	His colour was bitwixe yelow and reed,
And he answered, and said thus: "Madame,	And he answerde, and seyde thus: "Madame,
And so befell that in a dawning,	And so bifel that in a dawenynge,
And companionable, and bore herself so fair	And compaignable, and bar hyrself so faire
Like azure were his legs and his toes;	Lyk asure were his legges and his toon;
That goes in the church on mass-days.	On messe-dayes that in the chirche gon.
No wine she drank, neither white nor red;	No wyn ne drank she, neither whit ne reed;
Full sooty was her bedchamber and also her hall,	Ful sooty was hire bour and eek hir halle,
Was once dwelling in a small cottage,	Was whilom dwellyng in a narwe cotage,
Be happy, though thou ride upon a nag.	Be blithe, though thou ryde upon a jade.
It is no use to tell his opinion.	Noght helpeth it to tellen his sentence.
Therefore, Sir Monk, dan Piers by your name,	Wherfore, sire Monk, daun Piers by youre name,
He spoke of how Fortune covered with a cloud	He spak how Fortune covered with a clowde
When men have been in great wealth and ease,	Whereas men han been in greet welthe and ese,
And God, that sits high in majesty,	And God, that sitteth heighe in magestee,
Of half a bushel flour, very well baked.	Of half a busshel flour, ful wel ybake.
And when she did espy this white thing,	And whan she gan this white thyng espye,
This John started up as fast as ever he could,	This John stirte up as faste as ever he myghte,
Who knew nothing of this foolish strife;	That wiste no thyng of this nyce stryf;
My daughter, who is come from such noble lineage?"	My doghter, that is come of swich lynage?"
He said, "Thou John, thou pig's-head, awake,	He seyde, "Thou John, thou swynes-heed, awak,
"By God," thought he, "I have gone all wrong.	"By God," thoughte he, "al wrang I have mysgon.
When thou go homeward by the mill,	Whan that thou wendest homward by the melle,
This jolly life have these two clerks led	This joly lyf han thise two clerkes lad
She gropes always further with her hand,	She gropeth alwey forther with hir hond,
To the cradle, and in his hand seized it,	Unto the cradel, and in his hand it hente,
Now may I say that I am nothing but a fool.	Now may I seyn that I is but an ape.
Aleyn answered, "I reckon him not worth a fly."	Aleyn answerde, "I counte hym nat a flye."
That in another he shall be relieved.	That in another he sal be releved.
May a wild fire upon their bodies fall!	A wilde fyr upon thair bodyes falle!
This miller has imbibed so much ale	This millere hath so wisely bibbed ale
As if he had hoarseness, or had a cold.	As he were on the quakke, or on the pose.
His daughter had a bed, all by herself,	His doghter hadde a bed, al by hirselve,
Get us some food and drink, and make us good cheer,	Get us som mete and drynke, and make us cheere,
My house is small, but you have learned the art of logic;	Myn hous is streit, but ye han lerned art;
Both the warden and all our fellows,	Bathe the wardeyn and oure felawes alle,
Go whistle thou, and I shall catch him here!"	Ga whistle thou, and I shal kepe hym heere!"
And when the miller saw that they were gone,	And whan the millere saugh that they were gon,
Curses come on his hand that tied him so carelessly,	Unthank come on his hand that boond hym so,
And began to cry "Help!" and "Wellaway!	And gan to crie "Harrow!" and "Weylaway!
And to the horse he goes gently;	And to the hors he goth hym faire and wel;
The more will I steal when I take.	The moore wol I stele whan I take.
And see how the meal falls down	And se how that the mele falles doun
To grind our grain and carry it home again;	To grynde oure corn and carie it ham agayn;
Aleyn spoke first: "All hail, Symond, in faith!	Aleyn spak first: "Al hayl, Symond, y-fayth!
And at the last the warden gave hem leave.	And at the laste the wardeyn yaf hem leve.
Then were there two young poor scholars,	Thanne were ther yonge povre scolers two,
And on one day it happened, at a time,	And on a day it happed, in a stounde,
Into some worthy family of noble ancestry;	Into som worthy blood of auncetrye;
In cradle it lay and was a good looking little boy.	In cradel it lay and was a propre page.
At least they would like their wives to think so.	Algate they wolde hire wyves wenden so.
On holidays before her would he go	On halydayes biforn hire wolde he go
A wife he had, come of noble kin;	A wyf he hadde, ycomen of noble kyn;
There was no man, for peril, dared touch him.	Ther was no man, for peril, dorste hym touche.
There goes a brook, and over that a bridge,	Ther gooth a brook, and over that a brigge,
"This drunk Miller has told us here	"This dronke Millere hath ytoold us heer
The devil made a reeve to preach,	The devel made a reve for to preche,
And ever since the tap has so run	And ever sithe hath so the tappe yronne
"Four live coals have we, which I shall describe --	"Foure gleedes han we, which I shal devyse --
Until it is rotten in rubbish or in straw.	Til it be roten in mullok or in stree.
He began to grouch, and criticized it a little.	He gan to grucche, and blamed it a lite.
People do service to Christ and to his saint.	Men doon to Crist and to his seint servyse.
To have respite three days and no more	To han respit thre dayes and namo
But half dead, with her neck carved there,	But half deed, with hir nekke ycorven there,
But in that bath her life she must leave,	But in that bath hir lyf she moste lete,
And he grew angry, and ordered that men should lead her	And he weex wroth, and bad men sholde hir lede
And taste it well, and stone thou shalt find it,	And taste it wel, and stoon thou shalt it fynde,
Cecile answered, "O foolish creature!	Cecile answerde, "O nyce creature!
Thou hast no other power nor any authority.	Thou hast noon oother power ne no leve.
Why speakest thou so proudly then to me?"	Why spekestow so proudly thanne to me?"
"O judge, confused in thy folly,	"O juge, confus in thy nycetee,
Forasmuch as we do reverence	For as muche as we doon a reverence
"And yet wrongful is thy perseverance.	"And yet in wrong is thy perseveraunce.
"Of whence?" said she, when she was asked,	"Of whennes?" quod she, whan that she was freyned,
And first of all, lo, this was his quesation.	And alderfirst, lo, this was his axynge.
Do sacrifice and burn incense to Jupiter.	Doon sacrifice and Juppiter encense.
With angels full of clearness and of light,	With aungels ful of cleernesse and of light,
But when they were brought to the place	But whan they weren to the place broght
"Now, Christ's own knights beloved and dear,	"Now, Cristes owene knyghtes leeve and deere,
He got himself permission of the executioners,	He gat hym of the tormentoures leve,
Who questioned them, and knew all their thought,	Which hem apposed, and knew al hire entente,
Perfect in his learning, God's knight.	Parfit in his lernynge, Goddes knyght.
Of Christ's coming, and teach (him) of His pains,	Of Cristes come, and of his peynes teche,
To whom answered Tiburce, "O sister dear,	To whom answerde Tiburce, "O suster deere,
"But there is a better life in another place,	"But ther is bettre lif in oother place,
Men should burn him in a fire so red	Men sholde hym brennen in a fyr so reed
First tell me where I must go, and to what man?"	First tel me whider I shal, and to what man?"
Said this blissful fair maid dear,	Seyde this blisful faire mayde deere,
To love a devotion to chastity."	Devocioun of chastitee to love."
Commends it, and says in this manner:	Commendeth it, and seith in this manere:
Until this time, my brother, indeed.	Unto this tyme, brother myn, ywis.
Valerian said: "Two crowns have we,	Valerian seyde: "Two corones han we,
And when he perceived the fragrance,	And whan that he the savour undernoom,
Assented to good counsel also,	Assentedest to good conseil also,
He gave that one, and after he did give	He yaf that oon, and after gan he take
"I believe all this thing," said Valerian,	"I leeve al this thyng," quod Valerian,
And did stand before Valerian.	And gan bifore Valerian to stonde.
The fruit of that same seed of chastity	The fruyt of thilke seed of chastitee
Valerian has gone to the place,	Valerian is to the place ygon,
"That from this town stands no more than three miles,	"That fro this toun ne stant but miles three,
Answered in reply, "If I must trust thee,	Answerde agayn, "If I shal trusten thee,
Who with great love, whether I wake or sleep,	That with greet love, wher so I wake or sleepe,
And privately to him she said at once,	And pryvely to hym she seyde anon,
Had next to her flesh clad herself in a hair shirt.	Hadde next hire flessh yclad hire in an haire.
Of Christ, and bore his gospel in her mind.	Of Crist, and bar his gospel in hir mynde.
And just as these scientists write	And right so as thise philosophres write
Comes from "heaven" and "leos," for which rightly	Of "hevene" and "leos" comth, for which by right
Because she set an example by good teaching;	For she ensample was by good techynge;
Wrote the story, and (I) follow her legend,	The storie wroot, and folwen hire legende,
Of my body, and also by the weight	Of my body, and also by the wighte
Be sinful, yet accept my faith.	Be synful, yet accepte my bileve.
Not only helpest them that pray thee,	Nat oonly helpest hem that preyen thee,
Within the blissful cloister of thy sides	Withinne the cloistre blisful of thy sydis
Thy maiden's death, that won by means of her merit	Thy maydens deeth, that wan thurgh hire merite
Which is the cause of such great ruin,	That cause is of so greet confusioun,
He is not aware that the fiend has him in hand.	He nys nat war the feend hath hym in honde.
Who is porter of the gate of pleasures	That porter of the gate is of delices,
Another tale;" and with that word he said,	Another tale;" and with that word he sayde,
"Well said, by the body of our Lord," said our Host,	"Wel seyd, by corpus dominus," quod oure Hoost,
"Nay," said this monk, "by God and Saint Martin,	"Nay," quod this monk, "by God and Seint Martyn,
Betray a word of anything that you tell me,	Biwreye a word of thyng that ye me telle,
Perhaps I can, in your unhappy situation,	Paraventure I may, in youre meschief,
For I may sing `alas and alack	For I may synge `allas and weylawey
Has labored you since the night began	Hath yow laboured sith the nyght bigan
"Oh my dear cousin, Don John," she said,	"O deere cosyn myn, daun John," she sayde,
And thus he sits until it was past nine o'clock.	And thus he sit til it was passed pryme.
To reckon with himself, as it well may be,	To rekene with hymself, wel may be,
Who was so welcome as my lord Don John,	Who was so welcome as my lord daun John,
A messenger, and has prayed Don John	A messager, and preyed hath daun John
He gave to the lord, and then to all his household,	He yaf the lord, and sitthe al his meynee,
But was as glad of this as a fowl is of day,	But was as glad therof as fowel of day,
This young monk, who had so handsome a face,	This yonge monk, that was so fair of face,
Then another must pay for our costs,	Thanne moot another payen for oure cost,
Such salutations and courtesies	Swiche salutaciouns and contenaunces
I pray to God that it may please you;	I prey to God that it may plesen yow;
That each of you must tell at the least	That ech of yow moot tellen atte leste
Unless a man is virtuous as well!	But if a man be vertuous withal!
In my opinion, there is no one that is here	As to my doom, ther is noon that is heere
And next I will speak of Cambalo,	And after wol I speke of Cambalo,
The king's son, of whom I told you.	The kynges sone, of which I yow tolde.
In which were painted all these false fowls,	In which were peynted alle thise false fowles,
Where she with her beak had hurt herself.	Ther as she with hire beek hadde hurt hirselve.
And has turned his truth false in this manner.	And hath his trouthe falsed in this wyse.
And to the wood he will go and eat worms;	And to the wode he wole and wormes ete;
I believe he had that text in mind,	I trowe he hadde thilke text in mynde,
And said to him thus: `Lo, I am all yours;	And seyde hym thus: `Lo, I am youres al;
When I heard him speak and saw his appearance.	Whan that I herde hym speke and saugh his hewe.
That Fortune would have it that he must depart	That Fortune wolde that he moste twynne
And shortly, this business had gone forth so far	And shortly, so ferforth this thyng is went
Nor so could thank a creature as he did to me!	Ne so koude thonke a wight as he dide me!
So ravished, as it seemed, for the joy	So ravysshed, as it semed, for the joye
`An honest creature and a thief think not alike.'	`A trewe wight and a theef thenken nat oon.'
Very frightened that he might die, as it seemed to me,	Forfered of his deeth, as thoughte me,
That are in accord with nobility in love.	That sownen into gentillesse of love.
It was so concealed under humble bearing,	It was so wrapped under humble cheere,
Until the falcon prayed her to be still,	Til that the faucon bad hire to be stille,
That Nature in your natural disposition has set.	That Nature in youre principles hath set.
And after she started up from her swoon,	And after that she of hir swough gan breyde,
Of your malady, if it lay in my power,	Of youre disese, if it lay in my myght,
Since I see no other creature hunt you.	Syn that I see noon oother wight yow chace.
"What is the cause, if it may be told,	"What is the cause, if it be for to telle,
Has understood what this falcon said,	Hath understonde what this faucon seyde,
In shape, in all that might reckoned be.	Of shap, of al that myghte yrekened be.
And continually she cried always and shrieked,	And evere in oon she cryde alwey and shrighte,
I should proceed to the main point,	I sholde to the knotte condescende,
What for the season and the dawning,	What for the seson and the morwenynge,
No higher was he when she was ready --	Noon hyer was he whan she redy was --
As is her governess, answered her at once,	As is hire maistresse, answerde hire anon,
And slept her first sleep, and then awoke.	And slepte hire firste sleep, and thanne awook.
Their dreams shall not now be told for me;	Hire dremes shul nat now been toold for me;
The nurse of digestion, the sleep,	The norice of digestioun, the sleep,
The manner and the form of all this matter,	The manere and the forme of al this thyng,
Or, if you wish to bid him go thence,	Or, if yow liste bidde hym thennes goon,
Which I shall you tell between us two(secretly).	Which I shal yow telle bitwix us two.
Where men wondered about a horse also,	Theras men wondreden on an hors also,
The service done, they sup all day long.	The service doon, they soupen al by day.
No man but Launcelot, and he is dead.	No man but Launcelot, and he is deed.
And on the dance he goes with Canacee.	And on the daunce he gooth with Canacee.
Rose from his table, where he sat full high.	Roos fro his bord, ther as he sat ful hye.
Therefore ceases their chattering and their wonder.	Therfore cesseth hir janglyng and hir wonder.
Then they speak of Canacee's ring,	Tho speeke they of Canacees ryng,
That would pierce throughout every thing,	That wolde percen thurghout every thyng,
How men might in it see such things.	Hou men myghte in it swiche thynges se.
And said, "He lies, for it is rather like	And seyde, "He lyeth, for it is rather lyk
And said it was like the Pegasus,	And seyden it was lyk the Pegasee,
Nature nor art could him not amend	Nature ne art ne koude hym nat amende
Until the knight has taught them the manner	Til that the knyght hath taught hem the manere
By certain officers appointed for this purpose;	With certeine officers ordeyned therfore;
It fails not while it is in your possesion."	It failleth nat whils it is in youre hoold."
Such power has that whatever man you smite	Swich vertu hath that what man so ye smyte
Is this: that if she wishes to wear it	Is this: that if hire lust it for to were
"And in addition to all this, if any fair lady	"And over al this, if any lady bright
And return again with twisting of a peg.	And turne ayeyn with writhyng of a pyn.
This is to say, in four and twenty hours --	This is to seyn, in foure and twenty houres --
Yet say I this, as to his general meaning:	Yet seye I this, as to commune entente:
Could not amend one word of his speech.	Ne koude hym nat amende with a word.
For marveling at this knight; him to behold	For merveille of this knyght; hym to biholde
While this king sits thus in his nobility,	Whil that this kyng sit thus in his nobleye,
I will not tell of their strange stews,	I wol nat tellen of hir strange sewes,
Against the sword of winter, keen and cold.	Agayn the swerd of wynter, keene and coold.
Exactly March , in the ordinary course of the year.	The laste Idus of March, after the yeer.
My English also is insufficient.	Myn Englissh eek is insufficient.
That there was nowhere such another man.	That ther was nowher swich another man.
In accord with the religion in which he was born	As of the secte of which that he was born
My will is good, and lo, my tale is this."	My wyl is good, and lo, my tale is this."
And Jankyn has won a new gown --	And Jankyn hath ywonne a newe gowne --
That I can affirm, I say for me,	That I may vouche sauf, I sey for me,
That equally the sound of it will go,	That equally the soun of it wol wende,
And to every spoke's end, in this manner,	And to every spokes ende, in this manere,
"My lord," said he, "when the weather is fair,	"My lord," quod he, "whan that the weder is fair,
Now stood the lord's squire at the board,	Now stood the lordes squier at the bord,
The rumbling of a fart, and every sound,	The rumblynge of a fart, and every soun,
Before this day, such a problem.	Biforn this day, of swich a question.
This false blasphemer who charged me	This false blasphemour that charged me
Is there anything else? Tell me faithfully."	Is ther oght elles? Telle me feithfully."
Of holy church -- God amend it soon!"	Of hooly chirche -- God amende it soone!"
Blasphemed has our holy convent as well."	Blasphemed hath oure hooly covent eke."
You look as if the wood were full of thieves.	Ye looken as the wode were ful of thevys.
Where there dwelt a man of greet honor,	Wher as ther woned a man of greet honour,
"Ah, false churl," said he, "for God's bones!	"A, false cherl," quod he, "for Goddes bones!
A thing that I have hidden in private."	A thyng that I have hyd in pryvetee."
That thou divide it so, my dear brother,	That thou departe it so, my deere brother,
With his false dissimulation.	With his false dissymulacioun.
He would take the sun out of this world.	He wolde bireve out of this world the sonne.
And yet, God knows, hardly the foundation	And yet, God woot, unnethe the fundement
But show to me all thy confession."	But shewe to me al thy confessioun."
He made it that the river was so small	He made that the ryver was so smal
His son was slain; there is no more to say.	His sone was slayn; ther is namoore to seye.
And right away this angry, cursed wretch	And right anon this irous, cursed wrecche
For God's love, drink more temperately!	For Goddes love, drynk moore attemprely!
"Angry Cambises was also a drunkard,	"Irous Cambises was eek dronkelewe,
His fellow; here he stands whole and alive.'	His felawe; heere he standeth hool alyve.'
Who said thus, `Thou hast thy fellow slain,	That seyde thus, `Thou hast thy felawe slayn,
And therefore pray I God both day and night	And therfore preye I God bothe day and nyght
As woman is, when she has become angry;	As womman is, whan she hath caught an ire;
Beware of Ire that in thy bosom sleeps;	Be war from Ire that in thy bosom slepeth;
And chide here the poor innocent,	And chiden heere the sely innocent,
Says that the workman is worthy of his hire.	Seith that the werkman worthy is his hyre.
Ah, give that convent half a quarter (four bushels) oats!	A, yif that covent half a quarter otes!
Farewell, my gold, for it is all gone!"	Farwel, my gold, for it is al ago!"
And by that lord who is called Saint Yve,	And by that lord that clepid is Seint Yve,
When they for souls say the psalm of David:	Whan they for soules seye the psalm of Davit:
`Blessed are they who are poor in spirit.'	`Blessed be they that povere in spirit been.'
Are to the high God more acceptable	Been to the hye God moore acceptable
Beware that -- I say no more, for it suffices.	War that -- I seye namoore, for it suffiseth.
He fasted long and was in meditation.	He fasted longe and was in contemplaunce.
The purity and the fasting of us friars	The clennesse and the fastynge of us freres
We live in poverty and in abstinence,	We lyve in poverte and in abstinence,
And up I rose, and all our convent as well,	And up I roos, and al oure covent eke,
Soon after you went out of this town."	Soone after that ye wente out of this toun."
Then had I with you enough plain food.	Thanne hadde I with yow hoomly suffisaunce.
This makes the fiend; this must be amended.	This maketh the feend; this moste ben amended.
"Now, by your leave, oh dear sir," said she,	"Now, by youre leve, o deere sire," quod she,
But of your great goodness, by your leave,	But of youre grete goodnesse, by youre leve,
And her embraces in his arms tightly,	And hire embraceth in his armes narwe,
Interpreting scripture is a glorious thing, certainly,	Glosynge is a glorious thyng, certeyn,
I saw you not this fortnight or more."	I saugh yow noght this fourtenyght or moore."
Have I upon this bench fared full well;	Have I upon this bench faren ful weel;
Tell forth thy tale, and spare it not at al."	Tel forth thy tale, and spare it nat at al."
Bacon or beef, or such thing as you find."	Bacon or beef, or swich thyng as ye fynde."
And wrote the names always, as he stood,	And wroot the names alwey, as he stood,
And when this friar had said all he intended,	And whan this frere had seyd al his entente,
Thanked be God, in prosperity and abundance.	Thanked be God, in wele and habundaunce.
And so befell that on a day this friar	And so bifel that on a day this frere
But nonetheless, for fear yet he quaked,	But natheles, for fere yet he quook,
Out of the devil's ass there began to rush	Out of the develes ers ther gonne dryve
That none of them shall come to this place?'	That noon of hem shal come to this place?'
Friars and fiends are but little different.	Freres and feendes been but lyte asonder.
The Prologue of the Summoner's Tale	The Prologe of the Somonours Tale.
wrongs that you have done against me and mine,	 wronges that ye have doon agayn me and myne,
And when the day came that his adversaries should appear in his presence,	And whan the day cam that his adversaries sholde appieren in his presence,
Wherefore I pray you, let mercy be in your heart,	Wherfore I pray yow, lat mercy been in youre herte,
And therefore I pray you that in this necessity and in this urgent matter	And therfore I prey yow that in this necessitee and in this nede
considered the power that they have given you upon themselves.	considered the power that they han yeve yow upon hemself.
And therefore it were better for you to lose so much wealth of your own	And therfore it were bettre for yow to lese so muchel good of youre owene
Which things arranged, every man returned to his house.	Whiche thynges ordeyned, every man retourned to his hous.
you will consider our great repentance and low submission	 ye wol considere oure grete repentaunce and lowe submyssioun
Then the wisest of them three answered for them all and said,	Thanne the wiseste of hem thre answerde for hem alle and seyde,
to stand surety for them and to be their guarantors.	to maken feith for hem and for to been hire borwes.
Which thing was carried out in deed.	Which thyng parfourned was in dede.
and that Melibee should with good heart receive his adversaries to forgiveness and mercy.	and that Melibee sholde receyve with good herte his adversaries to foryifnesse and mercy.
For the law says, `There is no thing so good in the natural course of events kind as for a thing	For the lawe seith, `Ther nys no thyng so good by wey of kynde as a thyng
For Seneca says, `There is the remission and forgiveness, where the confession is,'	For Senec seith, `Ther is the remissioun and foryifnesse, where as the confessioun is,'
and are ready to come, what day that it pleases unto your noblesse to limit us or assign us,	and been redy to comen, what day that it like unto youre noblesse to lymyte us or assigne us,
by a stronger reason he prohibits and forbids a man to give himself to his enemy.	by a strenger resoun he deffendeth and forbedeth a man to yeven hymself to his enemy.
we nor our friends are not dispossessed nor destroyed through our folly."	we ne oure freendes be nat desherited ne destroyed thurgh oure folye."
and are ready to obey to the speech and commandment of my lord	and been redy to obeye to the speche and comandement of my lord Melibee.
they were so taken and ravished and had such great joy of her that it was a wonder to tell.	they weren so supprised and ravysshed and hadden so greet joye of hire that wonder was to telle.
for I put me wholly in your disposition and ordinance."	for I putte me hoolly in youre disposicioun and ordinaunce."
For, as I have said to you here before this, God has allowed you	For, as I have seyd yow heer biforn, God hath suffred yow
And this same Solomon says afterward that	And this same Salomon seith afterward that
Therefore the prophet says that `troubled eyes have no clear sight.'	Therfore the prophete seith that `troubled eyen han no cleer sighte.'
and the reconciling begins by thyself.'	 and the reconsilyng bygynneth by thyself.'
Indeed, that would not be to my honor.	For sothe, that were nat my worshipe.
and by debate and discord the great riches fall down.'	and by debaat and discord the grete richesses fallen doun.'
for as easily is one hurt with one spear as another';	for as lightly is oon hurt with a spere as another';
`As easily,' said he, `may our Lord God Almighty give victory to a few folk as to many folk,	`Als lightly,' quod he, `may oure Lord God Almyghty yeve victorie to a fewe folk as to many folk,
And, dear sir, although it be so that for your riches you can have much folk,	And, deere sire, al be it so that for youre richesses ye mowe have muchel folk,
that he displeases, and sets at naught his good name or reputation,	that he displeseth, and setteth at noght his goode name or loos,
`in keeping of thy friend and of thy good name;	`in kepyng of thy freend and of thy goode name;
providing that you get them with good conscience.	so that ye gete hem with good conscience.
Afterward, in getting of your riches and in using them you must always have three things in your heart	Afterward, in getynge of youre richesses and in usynge hem ye shul alwey have thre thynges in youre herte
and knows well, or ought know, that when he is dead	and knoweth wel, or oghte knowe, that whan he is deed
when they have no more property of their own, they devote themselves to taking the goods of another man.	whan they han namoore propre of hir owene, they shapen hem to take the goodes of another man.
in such a manner that men consider you not too niggardly, nor too frugal, nor too foolishly generous	in swich a manere that men holde yow nat to scars, ne to sparynge, ne to fool-large
And he that is idle and slow can never find suitable time to earn his profit.	And he that is ydel and slow kan nevere fynde covenable tyme for to doon his profit.
any man make himself rich unto the harm of another person.	no man make hymself riche unto the harm of another persone.
For a man that is too desiring to get riches devotes himself	For a man that is to desirynge to gete richesses abaundoneth hym
and if be begs, he dies for shame, and yet necessity constrains him to beg.'	and if he axe, he dyeth for shame; and algates necessitee constreyneth hym to axe.'
just so by poverty come there many harms and evils,	right so by poverte come ther manye harmes and yveles,
And therefore says Pamphilles: `If a cowherd's daughter,' says he, `is rich,	And therfore seith Pamphilles: `If a net-herdes doghter,' seith he, `be riche,
are all the things of this world governed.	been alle the thynges of this world governed.
is like to him that takes an hound by the ears.'	is lyk to hym that taketh an hound by the eris.'
By God, you know well that you make no defense	Pardee, ye knowen wel that ye maken no deffense
and not by excess nor by outrage.	and noght by excesse ne by outrage.
And although it be so that it was great peril to my enemies	And al be it so that it was greet peril to myne enemys
And the same Solomon says, `The angry and wrathful man makes quarrels,	And the same Salomon seith, `The angry and wrathful man maketh noyses,
ought much stir you to patience.	oghte muchel stiren yow to pacience.
the pains and the tribulations that he suffers seem the less unto him;	the peynes and the tribulaciouns that he suffreth semen the lesse unto hym;
for he that once has grieved thee, may another time relieve thee and help.'	for he that oones hath greved thee, may another tyme releeve thee and helpe.'
and to strive with a weaker man, it is folly.'	and for to stryve with a weyker man, it is folie.'
and at the last make them lose their lordships.	and atte laste maken hem lesen hire lordshipes.
"Certainly," said Prudence, "I grant you that over-much patience is not good.	"Certes," quod Prudence, "I graunte yow that over-muchel suffraunce is nat good.
`Leave the vengeance to me, and I shall do it.'"	`Leveth the vengeance to me, and I shal do it.'"
she will fail thee and deceive thee.	she wol faille thee and deceyve thee.
I consider now and take heed how Fortune has nourished me from my childhood	I bithenke me now and take heede how Fortune hath norissed me fro my childhede
And as Cassiodorus says, `A man dreads to do outrages when he knows and is aware	And as Cassidore seith, `A man dredeth to do outrages whan he woot and knoweth
that I shall not avenge me on my enemies,	that I shal nat venge me of myne enemys,
for certainly, the three enemies of mankind	for certes, the three enemys of mankynde
that thou art drunk and hast forgotten Jesus Christ thy creator.	that thou art dronken and hast forgeten Jhesu Crist thy creatour.
because the Book of Decrees says, `Seldom, or with great effort, are causes brought to a good end	by cause that the Book of Decrees seith, `Seelden, or with greet peyne, been causes ybroght to good ende
this is to say, the far cause and the near cause.	this is to seyn, the fer cause and the ny cause.
and thereof follows another vengeance, peril, and war, and other damages without number,	and therof folweth another vengeaunce, peril, and werre, and othere damages withoute nombre,
And yet moreover of that word that Cicero calls `consenting,'	And yet mooreover of thilke word that Tullius clepeth `consentynge,'
And though it so be that your kin are more sure and steadfast than the kin of your adversary,	And though so be that youre kynrede be moore siker and stedefast than the kyn of youre adversarie,
Let us now consider which are they that you consider so greatly your friends as to your person.	Lat us now considere whiche been they that ye holde so greetly youre freendes as to youre persone.
they have done to you all this wrong and all this villainy.	they han to yow doon al this wrong and al this vileynye.
your old enemies reconciled, your flatterers,	youre olde enemys reconsiled, youre flatereres,
and wise advisors said that you ought not suddenly nor hastily proceed in this urgent matter,	and wise conseillours seyden that yow ne oghte nat sodeynly ne hastily proceden in this nede,
And also men make high towers, [and great edifices] with great expenditures and with great travail,	And eek men make heighe toures, [and grete edifices] with grete costages and with greet travaille,
For the book says, `With scorners make no company, but flee their words as venom.'	For the book seith, `With scorneres make no compaignye, but flee hire wordes as venym.'
yet shalt thou always do thy best efforts in guarding of thy person;	yet shaltow alwey do thy diligence in kepynge of thy persone;
that, for any confidence in your strength, that you nor despise not, nor account not the might	that, for any presumpcion of youre strengthe, that ye ne dispise nat, ne accompte nat the myght
For Petrus Alphonsus says, `take no company by the way of a strange man,	For Piers Alfonce seith, `Ne taak no compaignye by the weye of a straunge man,
without the protection of our Lord Jesus Christ.	withouten the kepyng of oure Lord Jhesu Crist.
But now will I speak to you of the advice which was given to you	But now wol I speke to yow of the conseil which that was yeven to yow
but each of them increases and aggravates the other.	but everich of hem encreesceth and aggreggeth oother.
that just as they have done me a contrary, right so should I do them another.	that right as they han doon me a contrarie, right so sholde I doon hem another.
And, sir, just as they have answered wisely and discretely,	And, sire, right as they han answered wisely and discreetly,
To this sentence answered immediately dame Prudence, and said,	To this sentence answered anon dame Prudence, and seyde,
And since you know well that men shall always find a greater number of fools than of wise men,	And sith ye woot wel that men shal alwey fynde a gretter nombre of fooles than of wise men,
to have been advised by these counselors only, and with little consultation,	to han been conseilled by thise conseillours oonly, and with litel avys,
and folk who do you reverence without love.	and folk that doon yow reverence withouten love.
be called an advising, but a motion or a moving of folly,	be called a conseillyng, but a mocioun or a moevyng of folye,
I should govern myself in the choice and in the retention of my advisors.	I shal governe me in the chesynge and in the withholdynge of my conseillours.
And Seneca says, `If thy plan is come to the ears of thine enemy, change thy plan.'	And Senec seith, `If thy conseil is comen to the eeris of thyn enemy, chaunge thy conseil.'
of which thou shalt repent, then is it better that thou suffer than begin.	of which thou shalt repente, thanne is it bettre that thou suffre than bigynne.
For the proverb says, `He who too much embraces, keeps little.'	For the proverbe seith, `He that to muche embraceth, distreyneth litel.'
And in all these things thou shalt chose the best and abandon all other things .	And in alle thise thynges thou shalt chese the beste and weyve alle othere thynges.
In the examining then of your advisor you shall consider many things .	In the examynynge thanne of youre conseillour ye shul considere manye thynges.
advise you one thing privately and counsel you the contrary openly.	conseille yow o thyng prively and conseille yow the contrarie openly.
they will pervert it into wickedness.'	they wol perverten it into wikkednesse.'
nor tell them not thy plans.'	ne telle hem nat thy conseil.'
The book says, `Thou shalt rather dread and flee from the sweet words of flattering praisers	The book seith, `Thou shalt rather drede and flee fro the sweete wordes of flaterynge preiseres
"Now, since I have told you of which folk you should be advised, now	"Now, sith that I have toold yow of which folk ye sholde been counseilled, now
And then shall you keep this for a general rule: First you shall call to your council	And thanne shul ye kepe this for a general reule: First shul ye clepen to youre conseil
And also he says that `a true friend is a strong defense; whoever finds it,	And eek he seith that `a trewe freend is a strong deffense; who so that it fyndeth,
And therefore men say that the rich man has seldom good advice, unless he have it of himself.	And therfore men seyn that the riche man hath seeld good conseil, but if he have it of hymself.
For Seneca says: `If it so be that thou can not hide thine own plans,	For Seneca seith: `If so be that thou ne mayst nat thyn owene conseil hyde,
then I advise you that you keep it secret.	thanne rede I yow that ye kepe it secree.
and certainly, that can never be accomplished,	and certes, that ne may nevere been accompliced,
he can do a thing that he can not do.	he may do thyng that he may nat do.
and prepare yourself with the aim that he give you advice and comfort, as Tobias taught his son:	and shapeth yow to swich entente that he yeve yow conseil and confort, as taughte Thobie his sone:
And also I will do for you so much that you shall have honor in this undertaking."	And eek I wol do to yow so muche that ye shul have honour in this cause."
`It is not good to be a man alone; let us make for him a helpmate similar to himself.'	`It is nat good to been a man alloone; make we to hym an helpe semblable to hymself.'
yet have men found very many a good woman, and very discrete and wise in giving counsel.	yet han men founde ful many a good womman, and ful discret and wis in conseillynge.
For understand now, you ask advice to do wickedness;	For understoond now, ye asken conseil to do wikkednesse;
sir, these words are understood of women that are gossips and wicked;	sire, thise wordes been understonde of wommen that been jangleresses and wikked;
For there is no creature so good that he does not lack	For ther nys no creature so good that hym ne wanteth
our Lord Jesus Christ, when he was risen from death to life,	oure Lord Jhesu Crist, whan he was risen fro deeth to lyve,
with all due respect to you, certainly you despise all women in this manner, and	save youre grace, certes ye despisen alle wommen in this wyse, and
And moreover, I say that though you have sworn and promised to accomplish	And mooreover, I seye that though ye han sworn and bihight to perfourne
give any power over thyself, for it would be better that thy children	ne yeve no power over thyself, for bettre it were that thy children
this is to say, if I, for thy advice, would change	this is to seyn, if I, for thy conseillyng, wolde chaungen
immediately he consented to their advice and fully affirmed their opinion.	anoon he consented to hir conseillyng and fully affermed hire sentence.
For Jesus son of Sirach says that "music in weeping is an annoying thing"; this is to say:	For Jhesus Syrak seith that "musik in wepynge is a noyous thyng"; this is to seyn:
who knows very little what war amounts to.	that woot ful litel what werre amounteth.
And by these causes we ask time for deliberation, and we shall then, by the grace of God, advise thee	And by thise causes we axen deliberacioun, and we shal thanne, by the grace of God, conseille thee
Therefore we ask leisure and opportunity to have deliberation in this case to judge.	Wherfore we axen leyser and espace to have deliberacion in this cas to deme.
are possible to befall for this same cause,	been possible to fallen for this same cause,
His neighbors full of envy, his feigned friends that seemed reconciled, and his flatterers	His neighebores ful of envye, his feyned freendes that semeden reconsiled, and his flatereres
"Sir," said he, "as to us surgeons it is our duty that we do to every person the best that we can,	"Sire," quod he, "as to us surgiens aperteneth that we do to every wight the beste that we kan,
(as it seemed by their appearance) to his love and into his grace;	as by hir semblaunt to his love and into his grace;
`Our Lord has given it to me; our Lord hath taken it from me; just as our Lord wished,	`Oure Lord hath yeve it me; oure Lord hath biraft it me; right as oure Lord hath wold,
And therefore, if you govern yourself by wisdom, put away sorrow out of your heart.	And therfore, if ye governe yow by sapience, put awey sorwe out of youre herte.
amongst folk in sorrow, but it is rather granted to him to weep.	amonges folk in sorwe, but it is rather graunted hym to wepe.
Your daughter, with the grace of God, shall recover and escape.	Youre doghter, with the grace of God, shal warisshe and escape.
that is called the Remedy of Love, where he says	that cleped is the Remedie of Love, where as he seith,
Three of his old foes have seen this, and set ladders to the walls of his house,	Thre of his olde foes han it espyed, and setten laddres to the walles of his hous,
